window_id,label,N_subject,N_fileobject,N_netflow,N_total,E_total,path,skipped,reason
e5-2019-05-09-marple1-drakon-1357-part-1,1,4455,22879,240,27574,49318,C:\Users\Ali\Desktop\ChatGPT Scripts\Graphs_Out\mal__e5-2019-05-09-marple1-drakon-1357-part-1.pt,False,
benign_000808,0,12017,12824,436,25277,49255,C:\Users\Ali\Desktop\ChatGPT Scripts\Graphs_Out\ben__benign_000808.pt,False,
benign_000720,0,5610,17392,1168,24170,49196,C:\Users\Ali\Desktop\ChatGPT Scripts\Graphs_Out\ben__benign_000720.pt,False,
benign_000794,0,4500,24543,275,29318,48798,C:\Users\Ali\Desktop\ChatGPT Scripts\Graphs_Out\ben__benign_000794.pt,False,
benign_000724,0,10844,13988,193,25025,48785,C:\Users\Ali\Desktop\ChatGPT Scripts\Graphs_Out\ben__benign_000724.pt,False,
benign_000112,0,9328,15929,402,25659,48005,C:\Users\Ali\Desktop\ChatGPT Scripts\Graphs_Out\ben__benign_000112.pt,False,
benign_000602,0,7214,18395,441,26050,47843,C:\Users\Ali\Desktop\ChatGPT Scripts\Graphs_Out\ben__benign_000602.pt,False,
benign_000192,0,9518,16873,683,27074,47536,C:\Users\Ali\Desktop\ChatGPT Scripts\Graphs_Out\ben__benign_000192.pt,False,
benign_000601,0,7887,20399,1058,29344,47002,C:\Users\Ali\Desktop\ChatGPT Scripts\Graphs_Out\ben__benign_000601.pt,False,
benign_000687,0,5708,15711,385,21804,46816,C:\Users\Ali\Desktop\ChatGPT Scripts\Graphs_Out\ben__benign_000687.pt,False,
benign_000905,0,8860,10199,126,19185,46756,C:\Users\Ali\Desktop\ChatGPT Scripts\Graphs_Out\ben__benign_000905.pt,False,
benign_000812,0,3540,17366,326,21232,46710,C:\Users\Ali\Desktop\ChatGPT Scripts\Graphs_Out\ben__benign_000812.pt,False,
benign_000906,0,8097,14644,386,23127,46646,C:\Users\Ali\Desktop\ChatGPT Scripts\Graphs_Out\ben__benign_000906.pt,False,
benign_000604,0,7137,15045,727,22909,46614,C:\Users\Ali\Desktop\ChatGPT Scripts\Graphs_Out\ben__benign_000604.pt,False,
benign_000679,0,9091,14518,233,23842,46212,C:\Users\Ali\Desktop\ChatGPT Scripts\Graphs_Out\ben__benign_000679.pt,False,
benign_000312,0,5294,20556,909,26759,46144,C:\Users\Ali\Desktop\ChatGPT Scripts\Graphs_Out\ben__benign_000312.pt,False,
benign_000749,0,9490,17214,158,26862,45580,C:\Users\Ali\Desktop\ChatGPT Scripts\Graphs_Out\ben__benign_000749.pt,False,
benign_000199,0,5301,19208,670,25179,45444,C:\Users\Ali\Desktop\ChatGPT Scripts\Graphs_Out\ben__benign_000199.pt,False,
benign_000210,0,5527,20361,1182,27070,45243,C:\Users\Ali\Desktop\ChatGPT Scripts\Graphs_Out\ben__benign_000210.pt,False,
benign_000674,0,6628,15317,161,22106,45195,C:\Users\Ali\Desktop\ChatGPT Scripts\Graphs_Out\ben__benign_000674.pt,False,
benign_000326,0,5640,18350,315,24305,45148,C:\Users\Ali\Desktop\ChatGPT Scripts\Graphs_Out\ben__benign_000326.pt,False,
benign_000201,0,8370,14703,443,23516,44837,C:\Users\Ali\Desktop\ChatGPT Scripts\Graphs_Out\ben__benign_000201.pt,False,
benign_000795,0,4194,19324,174,23692,44607,C:\Users\Ali\Desktop\ChatGPT Scripts\Graphs_Out\ben__benign_000795.pt,False,
benign_000878,0,8488,10086,247,18821,44593,C:\Users\Ali\Desktop\ChatGPT Scripts\Graphs_Out\ben__benign_000878.pt,False,
benign_000672,0,7320,16408,879,24607,44573,C:\Users\Ali\Desktop\ChatGPT Scripts\Graphs_Out\ben__benign_000672.pt,False,
benign_000221,0,7891,17834,372,26097,44244,C:\Users\Ali\Desktop\ChatGPT Scripts\Graphs_Out\ben__benign_000221.pt,False,
benign_000236,0,5565,18733,209,24507,44119,C:\Users\Ali\Desktop\ChatGPT Scripts\Graphs_Out\ben__benign_000236.pt,False,
benign_000778,0,10904,14397,265,25566,44071,C:\Users\Ali\Desktop\ChatGPT Scripts\Graphs_Out\ben__benign_000778.pt,False,
benign_000698,0,4119,17811,195,22125,43479,C:\Users\Ali\Desktop\ChatGPT Scripts\Graphs_Out\ben__benign_000698.pt,False,
benign_000035,0,7040,18256,226,25522,43095,C:\Users\Ali\Desktop\ChatGPT Scripts\Graphs_Out\ben__benign_000035.pt,False,
benign_000202,0,6805,18797,544,26146,42894,C:\Users\Ali\Desktop\ChatGPT Scripts\Graphs_Out\ben__benign_000202.pt,False,
benign_000238,0,5727,21869,328,27924,42720,C:\Users\Ali\Desktop\ChatGPT Scripts\Graphs_Out\ben__benign_000238.pt,False,
benign_000642,0,4032,22363,174,26569,42500,C:\Users\Ali\Desktop\ChatGPT Scripts\Graphs_Out\ben__benign_000642.pt,False,
benign_000683,0,2862,19477,255,22594,42436,C:\Users\Ali\Desktop\ChatGPT Scripts\Graphs_Out\ben__benign_000683.pt,False,
benign_000606,0,7016,14216,446,21678,42406,C:\Users\Ali\Desktop\ChatGPT Scripts\Graphs_Out\ben__benign_000606.pt,False,
benign_000909,0,7907,11896,132,19935,42231,C:\Users\Ali\Desktop\ChatGPT Scripts\Graphs_Out\ben__benign_000909.pt,False,
benign_000419,0,4718,23562,156,28436,42020,C:\Users\Ali\Desktop\ChatGPT Scripts\Graphs_Out\ben__benign_000419.pt,False,
benign_000494,0,8152,11779,219,20150,41995,C:\Users\Ali\Desktop\ChatGPT Scripts\Graphs_Out\ben__benign_000494.pt,False,
benign_000689,0,3624,17487,1317,22428,41358,C:\Users\Ali\Desktop\ChatGPT Scripts\Graphs_Out\ben__benign_000689.pt,False,
benign_000593,0,5500,18978,688,25166,41321,C:\Users\Ali\Desktop\ChatGPT Scripts\Graphs_Out\ben__benign_000593.pt,False,
benign_000292,0,8474,14517,174,23165,41062,C:\Users\Ali\Desktop\ChatGPT Scripts\Graphs_Out\ben__benign_000292.pt,False,
benign_000426,0,5300,21826,191,27317,41054,C:\Users\Ali\Desktop\ChatGPT Scripts\Graphs_Out\ben__benign_000426.pt,False,
benign_000196,0,4731,17912,300,22943,40616,C:\Users\Ali\Desktop\ChatGPT Scripts\Graphs_Out\ben__benign_000196.pt,False,
benign_000502,0,5372,13900,438,19710,40415,C:\Users\Ali\Desktop\ChatGPT Scripts\Graphs_Out\ben__benign_000502.pt,False,
benign_000911,0,9515,9694,135,19344,40414,C:\Users\Ali\Desktop\ChatGPT Scripts\Graphs_Out\ben__benign_000911.pt,False,
benign_000095,0,2556,16183,1868,20607,40337,C:\Users\Ali\Desktop\ChatGPT Scripts\Graphs_Out\ben__benign_000095.pt,False,
benign_000240,0,4180,18004,496,22680,40123,C:\Users\Ali\Desktop\ChatGPT Scripts\Graphs_Out\ben__benign_000240.pt,False,
benign_000113,0,6535,16632,241,23408,40119,C:\Users\Ali\Desktop\ChatGPT Scripts\Graphs_Out\ben__benign_000113.pt,False,
benign_000032,0,5480,17143,440,23063,39661,C:\Users\Ali\Desktop\ChatGPT Scripts\Graphs_Out\ben__benign_000032.pt,False,
benign_000650,0,7485,20221,235,27941,39555,C:\Users\Ali\Desktop\ChatGPT Scripts\Graphs_Out\ben__benign_000650.pt,False,
benign_000370,0,8325,10194,100,18619,39247,C:\Users\Ali\Desktop\ChatGPT Scripts\Graphs_Out\ben__benign_000370.pt,False,
benign_000605,0,9840,11675,266,21781,39166,C:\Users\Ali\Desktop\ChatGPT Scripts\Graphs_Out\ben__benign_000605.pt,False,
benign_000190,0,5482,23617,212,29311,39146,C:\Users\Ali\Desktop\ChatGPT Scripts\Graphs_Out\ben__benign_000190.pt,False,
benign_000617,0,4821,19618,230,24669,38794,C:\Users\Ali\Desktop\ChatGPT Scripts\Graphs_Out\ben__benign_000617.pt,False,
benign_000726,0,1809,21613,103,23525,38767,C:\Users\Ali\Desktop\ChatGPT Scripts\Graphs_Out\ben__benign_000726.pt,False,
benign_000044,0,7089,16639,274,24002,38694,C:\Users\Ali\Desktop\ChatGPT Scripts\Graphs_Out\ben__benign_000044.pt,False,
benign_000716,0,4800,17180,287,22267,38621,C:\Users\Ali\Desktop\ChatGPT Scripts\Graphs_Out\ben__benign_000716.pt,False,
benign_000620,0,3566,19408,234,23208,38495,C:\Users\Ali\Desktop\ChatGPT Scripts\Graphs_Out\ben__benign_000620.pt,False,
benign_000594,0,5734,18018,265,24017,38093,C:\Users\Ali\Desktop\ChatGPT Scripts\Graphs_Out\ben__benign_000594.pt,False,
benign_000203,0,4853,16517,636,22006,37806,C:\Users\Ali\Desktop\ChatGPT Scripts\Graphs_Out\ben__benign_000203.pt,False,
benign_000822,0,11440,6683,91,18214,37666,C:\Users\Ali\Desktop\ChatGPT Scripts\Graphs_Out\ben__benign_000822.pt,False,
benign_000218,0,2257,26957,205,29419,37664,C:\Users\Ali\Desktop\ChatGPT Scripts\Graphs_Out\ben__benign_000218.pt,False,
benign_000695,0,3666,16260,675,20601,37414,C:\Users\Ali\Desktop\ChatGPT Scripts\Graphs_Out\ben__benign_000695.pt,False,
benign_000599,0,4333,20867,1621,26821,37387,C:\Users\Ali\Desktop\ChatGPT Scripts\Graphs_Out\ben__benign_000599.pt,False,
benign_000722,0,3496,16963,1636,22095,37266,C:\Users\Ali\Desktop\ChatGPT Scripts\Graphs_Out\ben__benign_000722.pt,False,
benign_000421,0,8172,11824,149,20145,37095,C:\Users\Ali\Desktop\ChatGPT Scripts\Graphs_Out\ben__benign_000421.pt,False,
benign_000107,0,4466,21246,746,26458,36637,C:\Users\Ali\Desktop\ChatGPT Scripts\Graphs_Out\ben__benign_000107.pt,False,
benign_000295,0,3301,15776,116,19193,36608,C:\Users\Ali\Desktop\ChatGPT Scripts\Graphs_Out\ben__benign_000295.pt,False,
benign_000499,0,8573,8706,152,17431,36247,C:\Users\Ali\Desktop\ChatGPT Scripts\Graphs_Out\ben__benign_000499.pt,False,
benign_000115,0,8059,14146,420,22625,36224,C:\Users\Ali\Desktop\ChatGPT Scripts\Graphs_Out\ben__benign_000115.pt,False,
benign_000434,0,4417,22037,119,26573,36106,C:\Users\Ali\Desktop\ChatGPT Scripts\Graphs_Out\ben__benign_000434.pt,False,
benign_000713,0,5295,15301,432,21028,35853,C:\Users\Ali\Desktop\ChatGPT Scripts\Graphs_Out\ben__benign_000713.pt,False,
benign_000049,0,3837,24908,222,28967,35735,C:\Users\Ali\Desktop\ChatGPT Scripts\Graphs_Out\ben__benign_000049.pt,False,
benign_000329,0,6221,15269,653,22143,35637,C:\Users\Ali\Desktop\ChatGPT Scripts\Graphs_Out\ben__benign_000329.pt,False,
benign_000026,0,7735,15319,561,23615,35473,C:\Users\Ali\Desktop\ChatGPT Scripts\Graphs_Out\ben__benign_000026.pt,False,
benign_000774,0,5045,14822,386,20253,35140,C:\Users\Ali\Desktop\ChatGPT Scripts\Graphs_Out\ben__benign_000774.pt,False,
benign_000027,0,4116,19186,440,23742,34998,C:\Users\Ali\Desktop\ChatGPT Scripts\Graphs_Out\ben__benign_000027.pt,False,
benign_000261,0,5104,14403,122,19629,34993,C:\Users\Ali\Desktop\ChatGPT Scripts\Graphs_Out\ben__benign_000261.pt,False,
benign_000318,0,5462,15347,366,21175,34772,C:\Users\Ali\Desktop\ChatGPT Scripts\Graphs_Out\ben__benign_000318.pt,False,
benign_000207,0,5188,14955,256,20399,34465,C:\Users\Ali\Desktop\ChatGPT Scripts\Graphs_Out\ben__benign_000207.pt,False,
benign_000591,0,3361,21376,492,25229,34276,C:\Users\Ali\Desktop\ChatGPT Scripts\Graphs_Out\ben__benign_000591.pt,False,
benign_000646,0,3697,21727,219,25643,34268,C:\Users\Ali\Desktop\ChatGPT Scripts\Graphs_Out\ben__benign_000646.pt,False,
benign_000803,0,4118,18766,1266,24150,34102,C:\Users\Ali\Desktop\ChatGPT Scripts\Graphs_Out\ben__benign_000803.pt,False,
benign_000600,0,3520,16237,817,20574,34021,C:\Users\Ali\Desktop\ChatGPT Scripts\Graphs_Out\ben__benign_000600.pt,False,
benign_000728,0,1984,18306,134,20424,34017,C:\Users\Ali\Desktop\ChatGPT Scripts\Graphs_Out\ben__benign_000728.pt,False,
benign_000337,0,7151,9618,180,16949,34012,C:\Users\Ali\Desktop\ChatGPT Scripts\Graphs_Out\ben__benign_000337.pt,False,
benign_000037,0,5165,23161,383,28709,33975,C:\Users\Ali\Desktop\ChatGPT Scripts\Graphs_Out\ben__benign_000037.pt,False,
benign_000034,0,4518,16237,269,21024,33900,C:\Users\Ali\Desktop\ChatGPT Scripts\Graphs_Out\ben__benign_000034.pt,False,
benign_000589,0,3246,17149,338,20733,33859,C:\Users\Ali\Desktop\ChatGPT Scripts\Graphs_Out\ben__benign_000589.pt,False,
benign_000246,0,2530,23141,124,25795,33806,C:\Users\Ali\Desktop\ChatGPT Scripts\Graphs_Out\ben__benign_000246.pt,False,
benign_000661,0,7403,10870,809,19082,33766,C:\Users\Ali\Desktop\ChatGPT Scripts\Graphs_Out\ben__benign_000661.pt,False,
benign_000125,0,2731,16254,173,19158,33674,C:\Users\Ali\Desktop\ChatGPT Scripts\Graphs_Out\ben__benign_000125.pt,False,
benign_000959,0,10746,6129,134,17009,33568,C:\Users\Ali\Desktop\ChatGPT Scripts\Graphs_Out\ben__benign_000959.pt,False,
benign_000740,0,4436,16169,104,20709,33512,C:\Users\Ali\Desktop\ChatGPT Scripts\Graphs_Out\ben__benign_000740.pt,False,
benign_000423,0,3238,19393,130,22761,33332,C:\Users\Ali\Desktop\ChatGPT Scripts\Graphs_Out\ben__benign_000423.pt,False,
benign_000402,0,6988,8706,486,16180,33237,C:\Users\Ali\Desktop\ChatGPT Scripts\Graphs_Out\ben__benign_000402.pt,False,
benign_000217,0,3819,15437,168,19424,33132,C:\Users\Ali\Desktop\ChatGPT Scripts\Graphs_Out\ben__benign_000217.pt,False,
benign_000775,0,2714,13928,191,16833,33079,C:\Users\Ali\Desktop\ChatGPT Scripts\Graphs_Out\ben__benign_000775.pt,False,
benign_000718,0,5661,12302,191,18154,33071,C:\Users\Ali\Desktop\ChatGPT Scripts\Graphs_Out\ben__benign_000718.pt,False,
benign_000710,0,5835,12499,366,18700,33055,C:\Users\Ali\Desktop\ChatGPT Scripts\Graphs_Out\ben__benign_000710.pt,False,
benign_000681,0,2843,15172,807,18822,32966,C:\Users\Ali\Desktop\ChatGPT Scripts\Graphs_Out\ben__benign_000681.pt,False,
benign_000057,0,2942,22954,227,26123,32869,C:\Users\Ali\Desktop\ChatGPT Scripts\Graphs_Out\ben__benign_000057.pt,False,
benign_000671,0,7114,11499,272,18885,32759,C:\Users\Ali\Desktop\ChatGPT Scripts\Graphs_Out\ben__benign_000671.pt,False,
benign_000111,0,4354,16432,1282,22068,32675,C:\Users\Ali\Desktop\ChatGPT Scripts\Graphs_Out\ben__benign_000111.pt,False,
benign_000704,0,5232,13469,205,18906,32639,C:\Users\Ali\Desktop\ChatGPT Scripts\Graphs_Out\ben__benign_000704.pt,False,
benign_000416,0,8005,10323,247,18575,32627,C:\Users\Ali\Desktop\ChatGPT Scripts\Graphs_Out\ben__benign_000416.pt,False,
benign_000294,0,3909,12798,139,16846,32619,C:\Users\Ali\Desktop\ChatGPT Scripts\Graphs_Out\ben__benign_000294.pt,False,
benign_000627,0,4797,22622,674,28093,32615,C:\Users\Ali\Desktop\ChatGPT Scripts\Graphs_Out\ben__benign_000627.pt,False,
benign_000209,0,5651,12778,392,18821,32453,C:\Users\Ali\Desktop\ChatGPT Scripts\Graphs_Out\ben__benign_000209.pt,False,
benign_000693,0,5054,12325,212,17591,32258,C:\Users\Ali\Desktop\ChatGPT Scripts\Graphs_Out\ben__benign_000693.pt,False,
benign_000813,0,4038,12865,178,17081,32183,C:\Users\Ali\Desktop\ChatGPT Scripts\Graphs_Out\ben__benign_000813.pt,False,
benign_000093,0,4053,16049,763,20865,32151,C:\Users\Ali\Desktop\ChatGPT Scripts\Graphs_Out\ben__benign_000093.pt,False,
benign_000886,0,9793,6576,93,16462,32129,C:\Users\Ali\Desktop\ChatGPT Scripts\Graphs_Out\ben__benign_000886.pt,False,
benign_000777,0,2787,11303,183,14273,32100,C:\Users\Ali\Desktop\ChatGPT Scripts\Graphs_Out\ben__benign_000777.pt,False,
benign_000960,0,2517,18397,70,20984,32094,C:\Users\Ali\Desktop\ChatGPT Scripts\Graphs_Out\ben__benign_000960.pt,False,
benign_000248,0,5842,12772,153,18767,32056,C:\Users\Ali\Desktop\ChatGPT Scripts\Graphs_Out\ben__benign_000248.pt,False,
benign_000648,0,3610,14192,165,17967,32013,C:\Users\Ali\Desktop\ChatGPT Scripts\Graphs_Out\ben__benign_000648.pt,False,
benign_000588,0,2392,15464,303,18159,31938,C:\Users\Ali\Desktop\ChatGPT Scripts\Graphs_Out\ben__benign_000588.pt,False,
benign_000611,0,3148,22921,219,26288,31407,C:\Users\Ali\Desktop\ChatGPT Scripts\Graphs_Out\ben__benign_000611.pt,False,
benign_000595,0,2740,19884,453,23077,31307,C:\Users\Ali\Desktop\ChatGPT Scripts\Graphs_Out\ben__benign_000595.pt,False,
benign_000732,0,4353,15501,109,19963,31252,C:\Users\Ali\Desktop\ChatGPT Scripts\Graphs_Out\ben__benign_000732.pt,False,
benign_000189,0,5171,15437,230,20838,31197,C:\Users\Ali\Desktop\ChatGPT Scripts\Graphs_Out\ben__benign_000189.pt,False,
benign_000333,0,4611,13566,613,18790,31177,C:\Users\Ali\Desktop\ChatGPT Scripts\Graphs_Out\ben__benign_000333.pt,False,
benign_000411,0,2881,18760,271,21912,31150,C:\Users\Ali\Desktop\ChatGPT Scripts\Graphs_Out\ben__benign_000411.pt,False,
benign_000609,0,3378,12379,464,16221,31026,C:\Users\Ali\Desktop\ChatGPT Scripts\Graphs_Out\ben__benign_000609.pt,False,
benign_000624,0,7135,9466,366,16967,30969,C:\Users\Ali\Desktop\ChatGPT Scripts\Graphs_Out\ben__benign_000624.pt,False,
benign_000779,0,4665,10630,639,15934,30894,C:\Users\Ali\Desktop\ChatGPT Scripts\Graphs_Out\ben__benign_000779.pt,False,
benign_000235,0,5741,11840,203,17784,30887,C:\Users\Ali\Desktop\ChatGPT Scripts\Graphs_Out\ben__benign_000235.pt,False,
benign_000764,0,3058,16913,165,20136,30885,C:\Users\Ali\Desktop\ChatGPT Scripts\Graphs_Out\ben__benign_000764.pt,False,
benign_000053,0,3155,23272,214,26641,30848,C:\Users\Ali\Desktop\ChatGPT Scripts\Graphs_Out\ben__benign_000053.pt,False,
benign_000769,0,2611,11555,259,14425,30635,C:\Users\Ali\Desktop\ChatGPT Scripts\Graphs_Out\ben__benign_000769.pt,False,
benign_000766,0,6062,9658,147,15867,30583,C:\Users\Ali\Desktop\ChatGPT Scripts\Graphs_Out\ben__benign_000766.pt,False,
benign_000748,0,2622,17513,96,20231,30398,C:\Users\Ali\Desktop\ChatGPT Scripts\Graphs_Out\ben__benign_000748.pt,False,
benign_000597,0,6807,12097,673,19577,30330,C:\Users\Ali\Desktop\ChatGPT Scripts\Graphs_Out\ben__benign_000597.pt,False,
benign_000690,0,3323,11006,687,15016,30316,C:\Users\Ali\Desktop\ChatGPT Scripts\Graphs_Out\ben__benign_000690.pt,False,
benign_000754,0,6194,9188,113,15495,30144,C:\Users\Ali\Desktop\ChatGPT Scripts\Graphs_Out\ben__benign_000754.pt,False,
benign_000200,0,5501,13278,232,19011,30127,C:\Users\Ali\Desktop\ChatGPT Scripts\Graphs_Out\ben__benign_000200.pt,False,
benign_000233,0,3294,15393,268,18955,29577,C:\Users\Ali\Desktop\ChatGPT Scripts\Graphs_Out\ben__benign_000233.pt,False,
benign_000741,0,2159,12663,264,15086,29553,C:\Users\Ali\Desktop\ChatGPT Scripts\Graphs_Out\ben__benign_000741.pt,False,
benign_000811,0,1548,20247,102,21897,29536,C:\Users\Ali\Desktop\ChatGPT Scripts\Graphs_Out\ben__benign_000811.pt,False,
benign_000912,0,7676,6620,154,14450,29361,C:\Users\Ali\Desktop\ChatGPT Scripts\Graphs_Out\ben__benign_000912.pt,False,
benign_000289,0,3153,12612,114,15879,29319,C:\Users\Ali\Desktop\ChatGPT Scripts\Graphs_Out\ben__benign_000289.pt,False,
benign_000378,0,8118,8066,126,16310,29315,C:\Users\Ali\Desktop\ChatGPT Scripts\Graphs_Out\ben__benign_000378.pt,False,
benign_000596,0,5840,12168,187,18195,29267,C:\Users\Ali\Desktop\ChatGPT Scripts\Graphs_Out\ben__benign_000596.pt,False,
benign_000702,0,4754,12191,236,17181,29178,C:\Users\Ali\Desktop\ChatGPT Scripts\Graphs_Out\ben__benign_000702.pt,False,
benign_000799,0,2512,16794,474,19780,29165,C:\Users\Ali\Desktop\ChatGPT Scripts\Graphs_Out\ben__benign_000799.pt,False,
benign_000045,0,3753,19957,338,24048,29138,C:\Users\Ali\Desktop\ChatGPT Scripts\Graphs_Out\ben__benign_000045.pt,False,
benign_000630,0,5446,10272,625,16343,29056,C:\Users\Ali\Desktop\ChatGPT Scripts\Graphs_Out\ben__benign_000630.pt,False,
benign_000643,0,3064,14838,122,18024,29055,C:\Users\Ali\Desktop\ChatGPT Scripts\Graphs_Out\ben__benign_000643.pt,False,
benign_000929,0,2918,10817,52,13787,28906,C:\Users\Ali\Desktop\ChatGPT Scripts\Graphs_Out\ben__benign_000929.pt,False,
benign_000430,0,3386,19016,302,22704,28721,C:\Users\Ali\Desktop\ChatGPT Scripts\Graphs_Out\ben__benign_000430.pt,False,
benign_000029,0,3498,23095,462,27055,28571,C:\Users\Ali\Desktop\ChatGPT Scripts\Graphs_Out\ben__benign_000029.pt,False,
benign_000701,0,5356,9355,227,14938,28429,C:\Users\Ali\Desktop\ChatGPT Scripts\Graphs_Out\ben__benign_000701.pt,False,
benign_000322,0,6308,10660,507,17475,28245,C:\Users\Ali\Desktop\ChatGPT Scripts\Graphs_Out\ben__benign_000322.pt,False,
benign_000729,0,4270,10970,134,15374,28191,C:\Users\Ali\Desktop\ChatGPT Scripts\Graphs_Out\ben__benign_000729.pt,False,
benign_000486,0,5100,10349,542,15991,28128,C:\Users\Ali\Desktop\ChatGPT Scripts\Graphs_Out\ben__benign_000486.pt,False,
benign_000490,0,3452,10558,258,14268,28075,C:\Users\Ali\Desktop\ChatGPT Scripts\Graphs_Out\ben__benign_000490.pt,False,
benign_000039,0,3975,14518,390,18883,28033,C:\Users\Ali\Desktop\ChatGPT Scripts\Graphs_Out\ben__benign_000039.pt,False,
benign_000108,0,3138,16118,319,19575,28021,C:\Users\Ali\Desktop\ChatGPT Scripts\Graphs_Out\ben__benign_000108.pt,False,
benign_000715,0,2708,13367,229,16304,27932,C:\Users\Ali\Desktop\ChatGPT Scripts\Graphs_Out\ben__benign_000715.pt,False,
benign_000388,0,5324,10869,736,16929,27877,C:\Users\Ali\Desktop\ChatGPT Scripts\Graphs_Out\ben__benign_000388.pt,False,
benign_000982,0,2228,11544,71,13843,27847,C:\Users\Ali\Desktop\ChatGPT Scripts\Graphs_Out\ben__benign_000982.pt,False,
benign_000583,0,2642,17090,175,19907,27698,C:\Users\Ali\Desktop\ChatGPT Scripts\Graphs_Out\ben__benign_000583.pt,False,
benign_000031,0,3909,13984,395,18288,27593,C:\Users\Ali\Desktop\ChatGPT Scripts\Graphs_Out\ben__benign_000031.pt,False,
benign_000895,0,3754,9687,103,13544,27571,C:\Users\Ali\Desktop\ChatGPT Scripts\Graphs_Out\ben__benign_000895.pt,False,
benign_000670,0,4574,10799,253,15626,27564,C:\Users\Ali\Desktop\ChatGPT Scripts\Graphs_Out\ben__benign_000670.pt,False,
benign_000655,0,2987,11996,174,15157,27530,C:\Users\Ali\Desktop\ChatGPT Scripts\Graphs_Out\ben__benign_000655.pt,False,
benign_000009,0,3992,25518,394,29904,27484,C:\Users\Ali\Desktop\ChatGPT Scripts\Graphs_Out\ben__benign_000009.pt,False,
benign_000498,0,3926,11331,161,15418,27446,C:\Users\Ali\Desktop\ChatGPT Scripts\Graphs_Out\ben__benign_000498.pt,False,
benign_000694,0,2361,13076,667,16104,27436,C:\Users\Ali\Desktop\ChatGPT Scripts\Graphs_Out\ben__benign_000694.pt,False,
benign_000721,0,3332,11259,212,14803,27296,C:\Users\Ali\Desktop\ChatGPT Scripts\Graphs_Out\ben__benign_000721.pt,False,
benign_000241,0,2901,11430,212,14543,27295,C:\Users\Ali\Desktop\ChatGPT Scripts\Graphs_Out\ben__benign_000241.pt,False,
benign_000204,0,2430,13674,289,16393,27269,C:\Users\Ali\Desktop\ChatGPT Scripts\Graphs_Out\ben__benign_000204.pt,False,
benign_000645,0,3006,11023,247,14276,27176,C:\Users\Ali\Desktop\ChatGPT Scripts\Graphs_Out\ben__benign_000645.pt,False,
benign_000744,0,1563,15718,104,17385,27050,C:\Users\Ali\Desktop\ChatGPT Scripts\Graphs_Out\ben__benign_000744.pt,False,
benign_000415,0,2041,17383,134,19558,26927,C:\Users\Ali\Desktop\ChatGPT Scripts\Graphs_Out\ben__benign_000415.pt,False,
benign_000011,0,3588,17035,401,21024,26904,C:\Users\Ali\Desktop\ChatGPT Scripts\Graphs_Out\ben__benign_000011.pt,False,
benign_000956,0,4702,13388,72,18162,26763,C:\Users\Ali\Desktop\ChatGPT Scripts\Graphs_Out\ben__benign_000956.pt,False,
benign_000262,0,2198,17697,133,20028,26723,C:\Users\Ali\Desktop\ChatGPT Scripts\Graphs_Out\ben__benign_000262.pt,False,
benign_000664,0,4583,10924,253,15760,26701,C:\Users\Ali\Desktop\ChatGPT Scripts\Graphs_Out\ben__benign_000664.pt,False,
benign_000592,0,3656,12929,198,16783,26581,C:\Users\Ali\Desktop\ChatGPT Scripts\Graphs_Out\ben__benign_000592.pt,False,
benign_000708,0,2208,10464,175,12847,26442,C:\Users\Ali\Desktop\ChatGPT Scripts\Graphs_Out\ben__benign_000708.pt,False,
benign_000352,0,8331,6591,226,15148,26429,C:\Users\Ali\Desktop\ChatGPT Scripts\Graphs_Out\ben__benign_000352.pt,False,
benign_000327,0,2081,15245,152,17478,26429,C:\Users\Ali\Desktop\ChatGPT Scripts\Graphs_Out\ben__benign_000327.pt,False,
benign_000696,0,2711,11165,193,14069,26359,C:\Users\Ali\Desktop\ChatGPT Scripts\Graphs_Out\ben__benign_000696.pt,False,
benign_000317,0,4044,11356,940,16340,26326,C:\Users\Ali\Desktop\ChatGPT Scripts\Graphs_Out\ben__benign_000317.pt,False,
benign_000785,0,7558,5790,210,13558,26246,C:\Users\Ali\Desktop\ChatGPT Scripts\Graphs_Out\ben__benign_000785.pt,False,
benign_000006,0,3616,15043,265,18924,26181,C:\Users\Ali\Desktop\ChatGPT Scripts\Graphs_Out\ben__benign_000006.pt,False,
benign_000669,0,4783,9754,176,14713,26099,C:\Users\Ali\Desktop\ChatGPT Scripts\Graphs_Out\ben__benign_000669.pt,False,
benign_000641,0,6691,9156,175,16022,26028,C:\Users\Ali\Desktop\ChatGPT Scripts\Graphs_Out\ben__benign_000641.pt,False,
benign_000016,0,3086,14443,405,17934,26020,C:\Users\Ali\Desktop\ChatGPT Scripts\Graphs_Out\ben__benign_000016.pt,False,
benign_000114,0,2872,13443,189,16504,25964,C:\Users\Ali\Desktop\ChatGPT Scripts\Graphs_Out\ben__benign_000114.pt,False,
benign_000010,0,4888,13030,318,18236,25936,C:\Users\Ali\Desktop\ChatGPT Scripts\Graphs_Out\ben__benign_000010.pt,False,
benign_000408,0,2349,10188,1033,13570,25877,C:\Users\Ali\Desktop\ChatGPT Scripts\Graphs_Out\ben__benign_000408.pt,False,
benign_000403,0,2170,16155,1106,19431,25844,C:\Users\Ali\Desktop\ChatGPT Scripts\Graphs_Out\ben__benign_000403.pt,False,
benign_000231,0,3769,11497,187,15453,25784,C:\Users\Ali\Desktop\ChatGPT Scripts\Graphs_Out\ben__benign_000231.pt,False,
benign_000492,0,2474,11197,217,13888,25776,C:\Users\Ali\Desktop\ChatGPT Scripts\Graphs_Out\ben__benign_000492.pt,False,
benign_000013,0,4549,24030,333,28912,25708,C:\Users\Ali\Desktop\ChatGPT Scripts\Graphs_Out\ben__benign_000013.pt,False,
benign_000250,0,2843,18959,180,21982,25660,C:\Users\Ali\Desktop\ChatGPT Scripts\Graphs_Out\ben__benign_000250.pt,False,
benign_000331,0,5616,9380,806,15802,25659,C:\Users\Ali\Desktop\ChatGPT Scripts\Graphs_Out\ben__benign_000331.pt,False,
benign_000851,0,6037,6012,54,12103,25612,C:\Users\Ali\Desktop\ChatGPT Scripts\Graphs_Out\ben__benign_000851.pt,False,
benign_000166,0,3378,19213,126,22717,25592,C:\Users\Ali\Desktop\ChatGPT Scripts\Graphs_Out\ben__benign_000166.pt,False,
benign_000706,0,4016,10499,483,14998,25550,C:\Users\Ali\Desktop\ChatGPT Scripts\Graphs_Out\ben__benign_000706.pt,False,
benign_000025,0,3397,19182,364,22943,25539,C:\Users\Ali\Desktop\ChatGPT Scripts\Graphs_Out\ben__benign_000025.pt,False,
benign_000213,0,3177,11686,172,15035,25519,C:\Users\Ali\Desktop\ChatGPT Scripts\Graphs_Out\ben__benign_000213.pt,False,
benign_000807,0,1580,18292,106,19978,25439,C:\Users\Ali\Desktop\ChatGPT Scripts\Graphs_Out\ben__benign_000807.pt,False,
benign_000640,0,5358,10812,348,16518,25427,C:\Users\Ali\Desktop\ChatGPT Scripts\Graphs_Out\ben__benign_000640.pt,False,
benign_000239,0,4409,9573,165,14147,25418,C:\Users\Ali\Desktop\ChatGPT Scripts\Graphs_Out\ben__benign_000239.pt,False,
benign_000249,0,4091,10419,146,14656,25366,C:\Users\Ali\Desktop\ChatGPT Scripts\Graphs_Out\ben__benign_000249.pt,False,
benign_000028,0,3286,14527,350,18163,25348,C:\Users\Ali\Desktop\ChatGPT Scripts\Graphs_Out\ben__benign_000028.pt,False,
benign_000667,0,2497,11089,308,13894,25325,C:\Users\Ali\Desktop\ChatGPT Scripts\Graphs_Out\ben__benign_000667.pt,False,
benign_000323,0,3371,10773,465,14609,25130,C:\Users\Ali\Desktop\ChatGPT Scripts\Graphs_Out\ben__benign_000323.pt,False,
benign_000365,0,3390,9757,145,13292,25106,C:\Users\Ali\Desktop\ChatGPT Scripts\Graphs_Out\ben__benign_000365.pt,False,
benign_000214,0,2503,17954,215,20672,25066,C:\Users\Ali\Desktop\ChatGPT Scripts\Graphs_Out\ben__benign_000214.pt,False,
benign_000023,0,4225,13366,354,17945,25027,C:\Users\Ali\Desktop\ChatGPT Scripts\Graphs_Out\ben__benign_000023.pt,False,
benign_000760,0,2223,18097,121,20441,25021,C:\Users\Ali\Desktop\ChatGPT Scripts\Graphs_Out\ben__benign_000760.pt,False,
benign_000792,0,5299,7302,132,12733,24967,C:\Users\Ali\Desktop\ChatGPT Scripts\Graphs_Out\ben__benign_000792.pt,False,
benign_000619,0,2452,20090,490,23032,24951,C:\Users\Ali\Desktop\ChatGPT Scripts\Graphs_Out\ben__benign_000619.pt,False,
benign_000272,0,5461,8731,125,14317,24882,C:\Users\Ali\Desktop\ChatGPT Scripts\Graphs_Out\ben__benign_000272.pt,False,
benign_000254,0,1699,18343,99,20141,24799,C:\Users\Ali\Desktop\ChatGPT Scripts\Graphs_Out\ben__benign_000254.pt,False,
benign_000117,0,1967,14834,171,16972,24760,C:\Users\Ali\Desktop\ChatGPT Scripts\Graphs_Out\ben__benign_000117.pt,False,
benign_000452,0,3352,10860,96,14308,24727,C:\Users\Ali\Desktop\ChatGPT Scripts\Graphs_Out\ben__benign_000452.pt,False,
benign_000441,0,3817,10258,180,14255,24721,C:\Users\Ali\Desktop\ChatGPT Scripts\Graphs_Out\ben__benign_000441.pt,False,
benign_000299,0,1730,11562,72,13364,24711,C:\Users\Ali\Desktop\ChatGPT Scripts\Graphs_Out\ben__benign_000299.pt,False,
benign_000094,0,1756,8426,2413,12595,24708,C:\Users\Ali\Desktop\ChatGPT Scripts\Graphs_Out\ben__benign_000094.pt,False,
benign_000258,0,1628,16841,96,18565,24645,C:\Users\Ali\Desktop\ChatGPT Scripts\Graphs_Out\ben__benign_000258.pt,False,
benign_000892,0,1202,13355,94,14651,24598,C:\Users\Ali\Desktop\ChatGPT Scripts\Graphs_Out\ben__benign_000892.pt,False,
benign_000014,0,2365,14061,217,16643,24508,C:\Users\Ali\Desktop\ChatGPT Scripts\Graphs_Out\ben__benign_000014.pt,False,
benign_000654,0,3173,19011,527,22711,24449,C:\Users\Ali\Desktop\ChatGPT Scripts\Graphs_Out\ben__benign_000654.pt,False,
benign_000767,0,6618,5899,609,13126,24376,C:\Users\Ali\Desktop\ChatGPT Scripts\Graphs_Out\ben__benign_000767.pt,False,
benign_000820,0,2304,9290,178,11772,24223,C:\Users\Ali\Desktop\ChatGPT Scripts\Graphs_Out\ben__benign_000820.pt,False,
benign_000649,0,1885,10761,154,12800,24216,C:\Users\Ali\Desktop\ChatGPT Scripts\Graphs_Out\ben__benign_000649.pt,False,
benign_000633,0,2309,10307,145,12761,24197,C:\Users\Ali\Desktop\ChatGPT Scripts\Graphs_Out\ben__benign_000633.pt,False,
benign_000784,0,1458,16464,110,18032,24123,C:\Users\Ali\Desktop\ChatGPT Scripts\Graphs_Out\ben__benign_000784.pt,False,
benign_000237,0,2157,10302,113,12572,24040,C:\Users\Ali\Desktop\ChatGPT Scripts\Graphs_Out\ben__benign_000237.pt,False,
benign_000186,0,3169,18451,171,21791,23808,C:\Users\Ali\Desktop\ChatGPT Scripts\Graphs_Out\ben__benign_000186.pt,False,
benign_000636,0,4300,10116,134,14550,23774,C:\Users\Ali\Desktop\ChatGPT Scripts\Graphs_Out\ben__benign_000636.pt,False,
benign_000651,0,2458,11213,145,13816,23746,C:\Users\Ali\Desktop\ChatGPT Scripts\Graphs_Out\ben__benign_000651.pt,False,
benign_000618,0,4236,14558,306,19100,23692,C:\Users\Ali\Desktop\ChatGPT Scripts\Graphs_Out\ben__benign_000618.pt,False,
benign_000362,0,5176,7593,92,12861,23676,C:\Users\Ali\Desktop\ChatGPT Scripts\Graphs_Out\ben__benign_000362.pt,False,
benign_000386,0,3008,9856,644,13508,23648,C:\Users\Ali\Desktop\ChatGPT Scripts\Graphs_Out\ben__benign_000386.pt,False,
benign_000439,0,5526,7845,97,13468,23500,C:\Users\Ali\Desktop\ChatGPT Scripts\Graphs_Out\ben__benign_000439.pt,False,
benign_000454,0,2034,15868,179,18081,23489,C:\Users\Ali\Desktop\ChatGPT Scripts\Graphs_Out\ben__benign_000454.pt,False,
benign_000071,0,5222,7162,201,12585,23448,C:\Users\Ali\Desktop\ChatGPT Scripts\Graphs_Out\ben__benign_000071.pt,False,
benign_000047,0,2905,11618,153,14676,23406,C:\Users\Ali\Desktop\ChatGPT Scripts\Graphs_Out\ben__benign_000047.pt,False,
benign_000770,0,3507,9774,385,13666,23380,C:\Users\Ali\Desktop\ChatGPT Scripts\Graphs_Out\ben__benign_000770.pt,False,
benign_000447,0,2057,10976,90,13123,23355,C:\Users\Ali\Desktop\ChatGPT Scripts\Graphs_Out\ben__benign_000447.pt,False,
benign_000162,0,2585,17329,127,20041,23343,C:\Users\Ali\Desktop\ChatGPT Scripts\Graphs_Out\ben__benign_000162.pt,False,
benign_000040,0,3807,10848,250,14905,23323,C:\Users\Ali\Desktop\ChatGPT Scripts\Graphs_Out\ben__benign_000040.pt,False,
benign_000264,0,4876,5785,90,10751,23322,C:\Users\Ali\Desktop\ChatGPT Scripts\Graphs_Out\ben__benign_000264.pt,False,
benign_000406,0,3366,9127,263,12756,23312,C:\Users\Ali\Desktop\ChatGPT Scripts\Graphs_Out\ben__benign_000406.pt,False,
benign_000154,0,2321,19267,146,21734,23295,C:\Users\Ali\Desktop\ChatGPT Scripts\Graphs_Out\ben__benign_000154.pt,False,
benign_000390,0,3016,9764,241,13021,23150,C:\Users\Ali\Desktop\ChatGPT Scripts\Graphs_Out\ben__benign_000390.pt,False,
benign_000017,0,3099,20418,199,23716,23128,C:\Users\Ali\Desktop\ChatGPT Scripts\Graphs_Out\ben__benign_000017.pt,False,
benign_000170,0,2456,18288,131,20875,23103,C:\Users\Ali\Desktop\ChatGPT Scripts\Graphs_Out\ben__benign_000170.pt,False,
benign_000260,0,5088,7469,81,12638,23033,C:\Users\Ali\Desktop\ChatGPT Scripts\Graphs_Out\ben__benign_000260.pt,False,
benign_000182,0,2538,20648,201,23387,23027,C:\Users\Ali\Desktop\ChatGPT Scripts\Graphs_Out\ben__benign_000182.pt,False,
benign_000242,0,2822,15590,117,18529,22957,C:\Users\Ali\Desktop\ChatGPT Scripts\Graphs_Out\ben__benign_000242.pt,False,
benign_000174,0,2447,16390,161,18998,22865,C:\Users\Ali\Desktop\ChatGPT Scripts\Graphs_Out\ben__benign_000174.pt,False,
benign_000409,0,3400,9106,133,12639,22800,C:\Users\Ali\Desktop\ChatGPT Scripts\Graphs_Out\ben__benign_000409.pt,False,
benign_000230,0,2441,16484,148,19073,22774,C:\Users\Ali\Desktop\ChatGPT Scripts\Graphs_Out\ben__benign_000230.pt,False,
benign_000675,0,1852,9998,172,12022,22725,C:\Users\Ali\Desktop\ChatGPT Scripts\Graphs_Out\ben__benign_000675.pt,False,
benign_000414,0,2669,9154,476,12299,22689,C:\Users\Ali\Desktop\ChatGPT Scripts\Graphs_Out\ben__benign_000414.pt,False,
benign_000862,0,5336,4660,113,10109,22671,C:\Users\Ali\Desktop\ChatGPT Scripts\Graphs_Out\ben__benign_000862.pt,False,
benign_000223,0,2606,11136,140,13882,22652,C:\Users\Ali\Desktop\ChatGPT Scripts\Graphs_Out\ben__benign_000223.pt,False,
benign_000738,0,2138,9743,203,12084,22609,C:\Users\Ali\Desktop\ChatGPT Scripts\Graphs_Out\ben__benign_000738.pt,False,
benign_000410,0,1597,9425,104,11126,22603,C:\Users\Ali\Desktop\ChatGPT Scripts\Graphs_Out\ben__benign_000410.pt,False,
benign_000714,0,3692,9050,183,12925,22595,C:\Users\Ali\Desktop\ChatGPT Scripts\Graphs_Out\ben__benign_000714.pt,False,
benign_000810,0,2613,10178,194,12985,22564,C:\Users\Ali\Desktop\ChatGPT Scripts\Graphs_Out\ben__benign_000810.pt,False,
benign_000158,0,2166,18248,137,20551,22505,C:\Users\Ali\Desktop\ChatGPT Scripts\Graphs_Out\ben__benign_000158.pt,False,
benign_000743,0,1816,8673,92,10581,22447,C:\Users\Ali\Desktop\ChatGPT Scripts\Graphs_Out\ben__benign_000743.pt,False,
benign_000110,0,3296,12702,365,16363,22342,C:\Users\Ali\Desktop\ChatGPT Scripts\Graphs_Out\ben__benign_000110.pt,False,
benign_000450,0,1964,16419,94,18477,22329,C:\Users\Ali\Desktop\ChatGPT Scripts\Graphs_Out\ben__benign_000450.pt,False,
benign_000495,0,2447,9852,199,12498,22297,C:\Users\Ali\Desktop\ChatGPT Scripts\Graphs_Out\ben__benign_000495.pt,False,
benign_000178,0,2208,16065,149,18422,22248,C:\Users\Ali\Desktop\ChatGPT Scripts\Graphs_Out\ben__benign_000178.pt,False,
benign_000644,0,2030,13054,171,15255,22247,C:\Users\Ali\Desktop\ChatGPT Scripts\Graphs_Out\ben__benign_000644.pt,False,
benign_000309,0,6723,11518,207,18448,22123,C:\Users\Ali\Desktop\ChatGPT Scripts\Graphs_Out\ben__benign_000309.pt,False,
benign_000662,0,2521,19238,261,22020,22093,C:\Users\Ali\Desktop\ChatGPT Scripts\Graphs_Out\ben__benign_000662.pt,False,
benign_000780,0,2346,13765,354,16465,21993,C:\Users\Ali\Desktop\ChatGPT Scripts\Graphs_Out\ben__benign_000780.pt,False,
benign_000787,0,1859,9428,193,11480,21980,C:\Users\Ali\Desktop\ChatGPT Scripts\Graphs_Out\ben__benign_000787.pt,False,
benign_000773,0,4776,9335,138,14249,21972,C:\Users\Ali\Desktop\ChatGPT Scripts\Graphs_Out\ben__benign_000773.pt,False,
benign_000297,0,1487,8673,593,10753,21953,C:\Users\Ali\Desktop\ChatGPT Scripts\Graphs_Out\ben__benign_000297.pt,False,
benign_000059,0,4326,10179,389,14894,21945,C:\Users\Ali\Desktop\ChatGPT Scripts\Graphs_Out\ben__benign_000059.pt,False,
benign_000123,0,2121,10045,118,12284,21938,C:\Users\Ali\Desktop\ChatGPT Scripts\Graphs_Out\ben__benign_000123.pt,False,
benign_000768,0,2192,13918,155,16265,21930,C:\Users\Ali\Desktop\ChatGPT Scripts\Graphs_Out\ben__benign_000768.pt,False,
benign_000234,0,1864,15480,136,17480,21876,C:\Users\Ali\Desktop\ChatGPT Scripts\Graphs_Out\ben__benign_000234.pt,False,
benign_000579,0,1759,14998,137,16894,21875,C:\Users\Ali\Desktop\ChatGPT Scripts\Graphs_Out\ben__benign_000579.pt,False,
benign_000321,0,2222,10062,1004,13288,21824,C:\Users\Ali\Desktop\ChatGPT Scripts\Graphs_Out\ben__benign_000321.pt,False,
benign_000469,0,3350,8491,93,11934,21757,C:\Users\Ali\Desktop\ChatGPT Scripts\Graphs_Out\ben__benign_000469.pt,False,
benign_000610,0,3033,12016,172,15221,21728,C:\Users\Ali\Desktop\ChatGPT Scripts\Graphs_Out\ben__benign_000610.pt,False,
benign_000752,0,4106,12696,95,16897,21637,C:\Users\Ali\Desktop\ChatGPT Scripts\Graphs_Out\ben__benign_000752.pt,False,
benign_000907,0,2185,8169,290,10644,21589,C:\Users\Ali\Desktop\ChatGPT Scripts\Graphs_Out\ben__benign_000907.pt,False,
benign_000479,0,3724,7956,523,12203,21586,C:\Users\Ali\Desktop\ChatGPT Scripts\Graphs_Out\ben__benign_000479.pt,False,
benign_000632,0,2965,8650,322,11937,21459,C:\Users\Ali\Desktop\ChatGPT Scripts\Graphs_Out\ben__benign_000632.pt,False,
benign_000215,0,3995,8581,484,13060,21387,C:\Users\Ali\Desktop\ChatGPT Scripts\Graphs_Out\ben__benign_000215.pt,False,
benign_000036,0,3206,11200,919,15325,21330,C:\Users\Ali\Desktop\ChatGPT Scripts\Graphs_Out\ben__benign_000036.pt,False,
benign_000399,0,2065,15251,230,17546,21260,C:\Users\Ali\Desktop\ChatGPT Scripts\Graphs_Out\ben__benign_000399.pt,False,
benign_000944,0,1016,13918,84,15018,21219,C:\Users\Ali\Desktop\ChatGPT Scripts\Graphs_Out\ben__benign_000944.pt,False,
benign_000444,0,2177,9674,89,11940,21161,C:\Users\Ali\Desktop\ChatGPT Scripts\Graphs_Out\ben__benign_000444.pt,False,
benign_000493,0,2256,9195,179,11630,21095,C:\Users\Ali\Desktop\ChatGPT Scripts\Graphs_Out\ben__benign_000493.pt,False,
benign_000736,0,1436,14330,102,15868,21021,C:\Users\Ali\Desktop\ChatGPT Scripts\Graphs_Out\ben__benign_000736.pt,False,
benign_000788,0,1885,8154,105,10144,20998,C:\Users\Ali\Desktop\ChatGPT Scripts\Graphs_Out\ben__benign_000788.pt,False,
benign_000446,0,1986,15127,146,17259,20998,C:\Users\Ali\Desktop\ChatGPT Scripts\Graphs_Out\ben__benign_000446.pt,False,
benign_000205,0,2302,10371,324,12997,20985,C:\Users\Ali\Desktop\ChatGPT Scripts\Graphs_Out\ben__benign_000205.pt,False,
benign_000220,0,2262,10928,131,13321,20978,C:\Users\Ali\Desktop\ChatGPT Scripts\Graphs_Out\ben__benign_000220.pt,False,
benign_000711,0,2163,9610,216,11989,20937,C:\Users\Ali\Desktop\ChatGPT Scripts\Graphs_Out\ben__benign_000711.pt,False,
benign_000626,0,2350,10664,406,13420,20859,C:\Users\Ali\Desktop\ChatGPT Scripts\Graphs_Out\ben__benign_000626.pt,False,
benign_000865,0,5534,4711,580,10825,20856,C:\Users\Ali\Desktop\ChatGPT Scripts\Graphs_Out\ben__benign_000865.pt,False,
benign_000385,0,2357,8860,341,11558,20835,C:\Users\Ali\Desktop\ChatGPT Scripts\Graphs_Out\ben__benign_000385.pt,False,
benign_000940,0,775,14014,50,14839,20818,C:\Users\Ali\Desktop\ChatGPT Scripts\Graphs_Out\ben__benign_000940.pt,False,
benign_000449,0,1609,9094,69,10772,20803,C:\Users\Ali\Desktop\ChatGPT Scripts\Graphs_Out\ben__benign_000449.pt,False,
benign_000699,0,3267,8838,268,12373,20788,C:\Users\Ali\Desktop\ChatGPT Scripts\Graphs_Out\ben__benign_000699.pt,False,
benign_000756,0,1597,13187,110,14894,20750,C:\Users\Ali\Desktop\ChatGPT Scripts\Graphs_Out\ben__benign_000756.pt,False,
benign_000796,0,1475,8153,147,9775,20743,C:\Users\Ali\Desktop\ChatGPT Scripts\Graphs_Out\ben__benign_000796.pt,False,
benign_000290,0,1839,8529,125,10493,20674,C:\Users\Ali\Desktop\ChatGPT Scripts\Graphs_Out\ben__benign_000290.pt,False,
benign_000815,0,2081,13780,313,16174,20659,C:\Users\Ali\Desktop\ChatGPT Scripts\Graphs_Out\ben__benign_000815.pt,False,
benign_000243,0,3170,8003,116,11289,20630,C:\Users\Ali\Desktop\ChatGPT Scripts\Graphs_Out\ben__benign_000243.pt,False,
benign_000859,0,5261,6046,64,11371,20591,C:\Users\Ali\Desktop\ChatGPT Scripts\Graphs_Out\ben__benign_000859.pt,False,
benign_000007,0,2784,13248,190,16222,20589,C:\Users\Ali\Desktop\ChatGPT Scripts\Graphs_Out\ben__benign_000007.pt,False,
benign_000712,0,2350,9694,278,12322,20584,C:\Users\Ali\Desktop\ChatGPT Scripts\Graphs_Out\ben__benign_000712.pt,False,
benign_000616,0,2285,8606,1060,11951,20376,C:\Users\Ali\Desktop\ChatGPT Scripts\Graphs_Out\ben__benign_000616.pt,False,
benign_000038,0,3409,11814,368,15591,20244,C:\Users\Ali\Desktop\ChatGPT Scripts\Graphs_Out\ben__benign_000038.pt,False,
benign_000109,0,3299,11183,1439,15921,20233,C:\Users\Ali\Desktop\ChatGPT Scripts\Graphs_Out\ben__benign_000109.pt,False,
benign_000791,0,1404,13913,175,15492,20178,C:\Users\Ali\Desktop\ChatGPT Scripts\Graphs_Out\ben__benign_000791.pt,False,
benign_000024,0,2811,11722,283,14816,20160,C:\Users\Ali\Desktop\ChatGPT Scripts\Graphs_Out\ben__benign_000024.pt,False,
benign_000310,0,3673,11334,457,15464,20132,C:\Users\Ali\Desktop\ChatGPT Scripts\Graphs_Out\ben__benign_000310.pt,False,
benign_000771,0,1973,8679,400,11052,20030,C:\Users\Ali\Desktop\ChatGPT Scripts\Graphs_Out\ben__benign_000771.pt,False,
benign_000697,0,4056,7788,376,12220,19991,C:\Users\Ali\Desktop\ChatGPT Scripts\Graphs_Out\ben__benign_000697.pt,False,
benign_000425,0,2060,9300,164,11524,19983,C:\Users\Ali\Desktop\ChatGPT Scripts\Graphs_Out\ben__benign_000425.pt,False,
benign_000719,0,3993,7742,247,11982,19980,C:\Users\Ali\Desktop\ChatGPT Scripts\Graphs_Out\ben__benign_000719.pt,False,
benign_000366,0,2081,8575,129,10785,19951,C:\Users\Ali\Desktop\ChatGPT Scripts\Graphs_Out\ben__benign_000366.pt,False,
benign_000191,0,2126,9749,170,12045,19948,C:\Users\Ali\Desktop\ChatGPT Scripts\Graphs_Out\ben__benign_000191.pt,False,
benign_000753,0,3996,7530,105,11631,19927,C:\Users\Ali\Desktop\ChatGPT Scripts\Graphs_Out\ben__benign_000753.pt,False,
benign_000367,0,1407,8036,61,9504,19902,C:\Users\Ali\Desktop\ChatGPT Scripts\Graphs_Out\ben__benign_000367.pt,False,
benign_000048,0,3372,10831,333,14536,19824,C:\Users\Ali\Desktop\ChatGPT Scripts\Graphs_Out\ben__benign_000048.pt,False,
benign_000347,0,1539,9542,120,11201,19798,C:\Users\Ali\Desktop\ChatGPT Scripts\Graphs_Out\ben__benign_000347.pt,False,
benign_000842,0,4739,6347,48,11134,19763,C:\Users\Ali\Desktop\ChatGPT Scripts\Graphs_Out\ben__benign_000842.pt,False,
benign_000324,0,2824,9369,1178,13371,19733,C:\Users\Ali\Desktop\ChatGPT Scripts\Graphs_Out\ben__benign_000324.pt,False,
benign_000634,0,3043,9414,129,12586,19728,C:\Users\Ali\Desktop\ChatGPT Scripts\Graphs_Out\ben__benign_000634.pt,False,
benign_000098,0,6819,5401,58,12278,19640,C:\Users\Ali\Desktop\ChatGPT Scripts\Graphs_Out\ben__benign_000098.pt,False,
benign_000745,0,1509,8387,119,10015,19515,C:\Users\Ali\Desktop\ChatGPT Scripts\Graphs_Out\ben__benign_000745.pt,False,
benign_000823,0,4452,6630,83,11165,19444,C:\Users\Ali\Desktop\ChatGPT Scripts\Graphs_Out\ben__benign_000823.pt,False,
benign_000872,0,1095,7337,128,8560,19422,C:\Users\Ali\Desktop\ChatGPT Scripts\Graphs_Out\ben__benign_000872.pt,False,
benign_000121,0,2298,10667,116,13081,19391,C:\Users\Ali\Desktop\ChatGPT Scripts\Graphs_Out\ben__benign_000121.pt,False,
benign_000881,0,1017,9621,87,10725,19386,C:\Users\Ali\Desktop\ChatGPT Scripts\Graphs_Out\ben__benign_000881.pt,False,
benign_000438,0,1913,15627,158,17698,19381,C:\Users\Ali\Desktop\ChatGPT Scripts\Graphs_Out\ben__benign_000438.pt,False,
benign_000805,0,1494,8903,134,10531,19368,C:\Users\Ali\Desktop\ChatGPT Scripts\Graphs_Out\ben__benign_000805.pt,False,
benign_000436,0,3843,6779,253,10875,19341,C:\Users\Ali\Desktop\ChatGPT Scripts\Graphs_Out\ben__benign_000436.pt,False,
benign_000197,0,2888,10109,478,13475,19267,C:\Users\Ali\Desktop\ChatGPT Scripts\Graphs_Out\ben__benign_000197.pt,False,
benign_000467,0,1634,8800,205,10639,19243,C:\Users\Ali\Desktop\ChatGPT Scripts\Graphs_Out\ben__benign_000467.pt,False,
benign_000776,0,2005,12877,421,15303,19220,C:\Users\Ali\Desktop\ChatGPT Scripts\Graphs_Out\ben__benign_000776.pt,False,
benign_000067,0,4423,7329,133,11885,19179,C:\Users\Ali\Desktop\ChatGPT Scripts\Graphs_Out\ben__benign_000067.pt,False,
benign_000404,0,4013,5344,196,9553,19166,C:\Users\Ali\Desktop\ChatGPT Scripts\Graphs_Out\ben__benign_000404.pt,False,
benign_000332,0,2939,9715,744,13398,19139,C:\Users\Ali\Desktop\ChatGPT Scripts\Graphs_Out\ben__benign_000332.pt,False,
benign_000247,0,2070,8757,191,11018,19024,C:\Users\Ali\Desktop\ChatGPT Scripts\Graphs_Out\ben__benign_000247.pt,False,
benign_000680,0,3288,8294,241,11823,18947,C:\Users\Ali\Desktop\ChatGPT Scripts\Graphs_Out\ben__benign_000680.pt,False,
benign_000058,0,3154,10085,237,13476,18908,C:\Users\Ali\Desktop\ChatGPT Scripts\Graphs_Out\ben__benign_000058.pt,False,
benign_000211,0,2924,8825,436,12185,18861,C:\Users\Ali\Desktop\ChatGPT Scripts\Graphs_Out\ben__benign_000211.pt,False,
benign_000925,0,3848,5598,264,9710,18735,C:\Users\Ali\Desktop\ChatGPT Scripts\Graphs_Out\ben__benign_000925.pt,False,
benign_000008,0,2893,11315,802,15010,18706,C:\Users\Ali\Desktop\ChatGPT Scripts\Graphs_Out\ben__benign_000008.pt,False,
benign_000420,0,2362,8434,126,10922,18633,C:\Users\Ali\Desktop\ChatGPT Scripts\Graphs_Out\ben__benign_000420.pt,False,
benign_000091,0,2347,8819,231,11397,18618,C:\Users\Ali\Desktop\ChatGPT Scripts\Graphs_Out\ben__benign_000091.pt,False,
benign_000442,0,1384,15562,59,17005,18590,C:\Users\Ali\Desktop\ChatGPT Scripts\Graphs_Out\ben__benign_000442.pt,False,
benign_000030,0,3032,10530,556,14118,18557,C:\Users\Ali\Desktop\ChatGPT Scripts\Graphs_Out\ben__benign_000030.pt,False,
benign_000251,0,1235,8577,76,9888,18534,C:\Users\Ali\Desktop\ChatGPT Scripts\Graphs_Out\ben__benign_000251.pt,False,
benign_000245,0,3276,8550,130,11956,18521,C:\Users\Ali\Desktop\ChatGPT Scripts\Graphs_Out\ben__benign_000245.pt,False,
benign_000585,0,4292,7278,149,11719,18520,C:\Users\Ali\Desktop\ChatGPT Scripts\Graphs_Out\ben__benign_000585.pt,False,
benign_000487,0,2254,7287,380,9921,18395,C:\Users\Ali\Desktop\ChatGPT Scripts\Graphs_Out\ben__benign_000487.pt,False,
benign_000271,0,1494,8135,69,9698,18343,C:\Users\Ali\Desktop\ChatGPT Scripts\Graphs_Out\ben__benign_000271.pt,False,
benign_000407,0,1492,13410,268,15170,18343,C:\Users\Ali\Desktop\ChatGPT Scripts\Graphs_Out\ben__benign_000407.pt,False,
benign_000319,0,2683,8337,169,11189,18323,C:\Users\Ali\Desktop\ChatGPT Scripts\Graphs_Out\ben__benign_000319.pt,False,
benign_000020,0,3191,9686,279,13156,18322,C:\Users\Ali\Desktop\ChatGPT Scripts\Graphs_Out\ben__benign_000020.pt,False,
benign_000224,0,3242,8234,230,11706,18259,C:\Users\Ali\Desktop\ChatGPT Scripts\Graphs_Out\ben__benign_000224.pt,False,
benign_000429,0,3954,7057,169,11180,18192,C:\Users\Ali\Desktop\ChatGPT Scripts\Graphs_Out\ben__benign_000429.pt,False,
benign_000653,0,2391,9086,153,11630,18184,C:\Users\Ali\Desktop\ChatGPT Scripts\Graphs_Out\ben__benign_000653.pt,False,
benign_000939,0,4756,4049,64,8869,18154,C:\Users\Ali\Desktop\ChatGPT Scripts\Graphs_Out\ben__benign_000939.pt,False,
benign_000637,0,2212,7637,176,10025,18145,C:\Users\Ali\Desktop\ChatGPT Scripts\Graphs_Out\ben__benign_000637.pt,False,
benign_000116,0,2047,9387,142,11576,18086,C:\Users\Ali\Desktop\ChatGPT Scripts\Graphs_Out\ben__benign_000116.pt,False,
benign_000639,0,1882,8478,198,10558,18074,C:\Users\Ali\Desktop\ChatGPT Scripts\Graphs_Out\ben__benign_000639.pt,False,
benign_000621,0,3739,9805,256,13800,18057,C:\Users\Ali\Desktop\ChatGPT Scripts\Graphs_Out\ben__benign_000621.pt,False,
benign_000709,0,2847,7659,745,11251,18041,C:\Users\Ali\Desktop\ChatGPT Scripts\Graphs_Out\ben__benign_000709.pt,False,
benign_000759,0,1921,7380,202,9503,18021,C:\Users\Ali\Desktop\ChatGPT Scripts\Graphs_Out\ben__benign_000759.pt,False,
benign_000105,0,3239,11959,284,15482,17912,C:\Users\Ali\Desktop\ChatGPT Scripts\Graphs_Out\ben__benign_000105.pt,False,
benign_000660,0,1841,8692,151,10684,17909,C:\Users\Ali\Desktop\ChatGPT Scripts\Graphs_Out\ben__benign_000660.pt,False,
benign_000733,0,3631,6768,121,10520,17897,C:\Users\Ali\Desktop\ChatGPT Scripts\Graphs_Out\ben__benign_000733.pt,False,
benign_000316,0,2619,9227,456,12302,17873,C:\Users\Ali\Desktop\ChatGPT Scripts\Graphs_Out\ben__benign_000316.pt,False,
benign_000428,0,1910,8517,208,10635,17812,C:\Users\Ali\Desktop\ChatGPT Scripts\Graphs_Out\ben__benign_000428.pt,False,
benign_000868,0,5276,4540,140,9956,17791,C:\Users\Ali\Desktop\ChatGPT Scripts\Graphs_Out\ben__benign_000868.pt,False,
benign_000389,0,1550,9624,140,11314,17683,C:\Users\Ali\Desktop\ChatGPT Scripts\Graphs_Out\ben__benign_000389.pt,False,
benign_000781,0,1686,7893,257,9836,17677,C:\Users\Ali\Desktop\ChatGPT Scripts\Graphs_Out\ben__benign_000781.pt,False,
benign_000876,0,4366,3482,63,7911,17625,C:\Users\Ali\Desktop\ChatGPT Scripts\Graphs_Out\ben__benign_000876.pt,False,
benign_000056,0,2490,9148,132,11770,17619,C:\Users\Ali\Desktop\ChatGPT Scripts\Graphs_Out\ben__benign_000056.pt,False,
benign_000328,0,2890,10401,182,13473,17579,C:\Users\Ali\Desktop\ChatGPT Scripts\Graphs_Out\ben__benign_000328.pt,False,
benign_000705,0,1893,8575,140,10608,17577,C:\Users\Ali\Desktop\ChatGPT Scripts\Graphs_Out\ben__benign_000705.pt,False,
benign_000330,0,2750,9032,185,11967,17491,C:\Users\Ali\Desktop\ChatGPT Scripts\Graphs_Out\ben__benign_000330.pt,False,
benign_000050,0,2724,9456,198,12378,17483,C:\Users\Ali\Desktop\ChatGPT Scripts\Graphs_Out\ben__benign_000050.pt,False,
benign_000665,0,1940,7182,211,9333,17451,C:\Users\Ali\Desktop\ChatGPT Scripts\Graphs_Out\ben__benign_000665.pt,False,
benign_000500,0,1593,8181,148,9922,17449,C:\Users\Ali\Desktop\ChatGPT Scripts\Graphs_Out\ben__benign_000500.pt,False,
benign_000491,0,1972,7492,174,9638,17426,C:\Users\Ali\Desktop\ChatGPT Scripts\Graphs_Out\ben__benign_000491.pt,False,
benign_000826,0,906,7888,77,8871,17371,C:\Users\Ali\Desktop\ChatGPT Scripts\Graphs_Out\ben__benign_000826.pt,False,
benign_000315,0,4273,6423,257,10953,17344,C:\Users\Ali\Desktop\ChatGPT Scripts\Graphs_Out\ben__benign_000315.pt,False,
benign_000913,0,1684,6923,119,8726,17340,C:\Users\Ali\Desktop\ChatGPT Scripts\Graphs_Out\ben__benign_000913.pt,False,
benign_000727,0,1522,7277,129,8928,17299,C:\Users\Ali\Desktop\ChatGPT Scripts\Graphs_Out\ben__benign_000727.pt,False,
benign_000581,0,1871,8454,176,10501,17242,C:\Users\Ali\Desktop\ChatGPT Scripts\Graphs_Out\ben__benign_000581.pt,False,
benign_000393,0,2072,8109,94,10275,17236,C:\Users\Ali\Desktop\ChatGPT Scripts\Graphs_Out\ben__benign_000393.pt,False,
benign_000270,0,1375,13799,97,15271,17208,C:\Users\Ali\Desktop\ChatGPT Scripts\Graphs_Out\ben__benign_000270.pt,False,
benign_000901,0,2158,6532,97,8787,17163,C:\Users\Ali\Desktop\ChatGPT Scripts\Graphs_Out\ben__benign_000901.pt,False,
benign_000742,0,2091,6383,180,8654,17156,C:\Users\Ali\Desktop\ChatGPT Scripts\Graphs_Out\ben__benign_000742.pt,False,
benign_000806,0,2034,7885,93,10012,17144,C:\Users\Ali\Desktop\ChatGPT Scripts\Graphs_Out\ben__benign_000806.pt,False,
benign_000070,0,2398,7451,155,10004,17083,C:\Users\Ali\Desktop\ChatGPT Scripts\Graphs_Out\ben__benign_000070.pt,False,
benign_000797,0,2361,6964,67,9392,17048,C:\Users\Ali\Desktop\ChatGPT Scripts\Graphs_Out\ben__benign_000797.pt,False,
benign_000266,0,1311,13859,105,15275,17045,C:\Users\Ali\Desktop\ChatGPT Scripts\Graphs_Out\ben__benign_000266.pt,False,
benign_000287,0,3557,6592,66,10215,17043,C:\Users\Ali\Desktop\ChatGPT Scripts\Graphs_Out\ben__benign_000287.pt,False,
benign_000614,0,2484,6794,278,9556,17001,C:\Users\Ali\Desktop\ChatGPT Scripts\Graphs_Out\ben__benign_000614.pt,False,
benign_000042,0,2721,9277,269,12267,16974,C:\Users\Ali\Desktop\ChatGPT Scripts\Graphs_Out\ben__benign_000042.pt,False,
benign_000320,0,2778,8428,414,11620,16921,C:\Users\Ali\Desktop\ChatGPT Scripts\Graphs_Out\ben__benign_000320.pt,False,
benign_000257,0,2111,6362,133,8606,16872,C:\Users\Ali\Desktop\ChatGPT Scripts\Graphs_Out\ben__benign_000257.pt,False,
benign_000489,0,1595,7778,168,9541,16848,C:\Users\Ali\Desktop\ChatGPT Scripts\Graphs_Out\ben__benign_000489.pt,False,
benign_000080,0,2100,9190,102,11392,16815,C:\Users\Ali\Desktop\ChatGPT Scripts\Graphs_Out\ben__benign_000080.pt,False,
benign_000762,0,1839,6968,137,8944,16803,C:\Users\Ali\Desktop\ChatGPT Scripts\Graphs_Out\ben__benign_000762.pt,False,
benign_000496,0,1896,6222,767,8885,16710,C:\Users\Ali\Desktop\ChatGPT Scripts\Graphs_Out\ben__benign_000496.pt,False,
benign_000206,0,2861,8520,243,11624,16691,C:\Users\Ali\Desktop\ChatGPT Scripts\Graphs_Out\ben__benign_000206.pt,False,
benign_000185,0,2302,12128,157,14587,16596,C:\Users\Ali\Desktop\ChatGPT Scripts\Graphs_Out\ben__benign_000185.pt,False,
benign_000455,0,1742,8156,70,9968,16496,C:\Users\Ali\Desktop\ChatGPT Scripts\Graphs_Out\ben__benign_000455.pt,False,
benign_000052,0,2548,9140,149,11837,16463,C:\Users\Ali\Desktop\ChatGPT Scripts\Graphs_Out\ben__benign_000052.pt,False,
benign_000804,0,3807,6245,83,10135,16462,C:\Users\Ali\Desktop\ChatGPT Scripts\Graphs_Out\ben__benign_000804.pt,False,
benign_000800,0,4827,5305,128,10260,16452,C:\Users\Ali\Desktop\ChatGPT Scripts\Graphs_Out\ben__benign_000800.pt,False,
benign_000488,0,1795,6617,274,8686,16407,C:\Users\Ali\Desktop\ChatGPT Scripts\Graphs_Out\ben__benign_000488.pt,False,
benign_000398,0,3088,5668,87,8843,16405,C:\Users\Ali\Desktop\ChatGPT Scripts\Graphs_Out\ben__benign_000398.pt,False,
benign_000216,0,2096,8271,164,10531,16405,C:\Users\Ali\Desktop\ChatGPT Scripts\Graphs_Out\ben__benign_000216.pt,False,
benign_000418,0,1678,7877,107,9662,16393,C:\Users\Ali\Desktop\ChatGPT Scripts\Graphs_Out\ben__benign_000418.pt,False,
benign_000401,0,1890,7424,114,9428,16340,C:\Users\Ali\Desktop\ChatGPT Scripts\Graphs_Out\ben__benign_000401.pt,False,
benign_000652,0,1518,7784,112,9414,16261,C:\Users\Ali\Desktop\ChatGPT Scripts\Graphs_Out\ben__benign_000652.pt,False,
benign_000060,0,1858,8180,160,10198,16200,C:\Users\Ali\Desktop\ChatGPT Scripts\Graphs_Out\ben__benign_000060.pt,False,
benign_000120,0,2587,7529,267,10383,16188,C:\Users\Ali\Desktop\ChatGPT Scripts\Graphs_Out\ben__benign_000120.pt,False,
benign_000801,0,1474,6909,199,8582,16123,C:\Users\Ali\Desktop\ChatGPT Scripts\Graphs_Out\ben__benign_000801.pt,False,
benign_000119,0,3079,6388,157,9624,16097,C:\Users\Ali\Desktop\ChatGPT Scripts\Graphs_Out\ben__benign_000119.pt,False,
benign_000232,0,1720,7342,163,9225,16004,C:\Users\Ali\Desktop\ChatGPT Scripts\Graphs_Out\ben__benign_000232.pt,False,
benign_000387,0,1407,7516,435,9358,15880,C:\Users\Ali\Desktop\ChatGPT Scripts\Graphs_Out\ben__benign_000387.pt,False,
benign_000725,0,1463,7956,148,9567,15825,C:\Users\Ali\Desktop\ChatGPT Scripts\Graphs_Out\ben__benign_000725.pt,False,
benign_000422,0,1748,7369,1272,10389,15789,C:\Users\Ali\Desktop\ChatGPT Scripts\Graphs_Out\ben__benign_000422.pt,False,
benign_000351,0,3289,6157,112,9558,15723,C:\Users\Ali\Desktop\ChatGPT Scripts\Graphs_Out\ben__benign_000351.pt,False,
benign_000985,0,563,5949,42,6554,15699,C:\Users\Ali\Desktop\ChatGPT Scripts\Graphs_Out\ben__benign_000985.pt,False,
benign_000790,0,3224,5316,325,8865,15683,C:\Users\Ali\Desktop\ChatGPT Scripts\Graphs_Out\ben__benign_000790.pt,False,
benign_000470,0,4045,4670,65,8780,15317,C:\Users\Ali\Desktop\ChatGPT Scripts\Graphs_Out\ben__benign_000470.pt,False,
benign_000483,0,2949,6441,107,9497,15313,C:\Users\Ali\Desktop\ChatGPT Scripts\Graphs_Out\ben__benign_000483.pt,False,
benign_000427,0,1645,7126,794,9565,15313,C:\Users\Ali\Desktop\ChatGPT Scripts\Graphs_Out\ben__benign_000427.pt,False,
benign_000464,0,1789,6160,151,8100,15312,C:\Users\Ali\Desktop\ChatGPT Scripts\Graphs_Out\ben__benign_000464.pt,False,
benign_000046,0,2547,8366,156,11069,15300,C:\Users\Ali\Desktop\ChatGPT Scripts\Graphs_Out\ben__benign_000046.pt,False,
benign_000313,0,2576,6836,193,9605,15247,C:\Users\Ali\Desktop\ChatGPT Scripts\Graphs_Out\ben__benign_000313.pt,False,
benign_000952,0,1081,11340,201,12622,15233,C:\Users\Ali\Desktop\ChatGPT Scripts\Graphs_Out\ben__benign_000952.pt,False,
benign_000431,0,1862,7432,221,9515,15205,C:\Users\Ali\Desktop\ChatGPT Scripts\Graphs_Out\ben__benign_000431.pt,False,
benign_000043,0,2401,9103,214,11718,15146,C:\Users\Ali\Desktop\ChatGPT Scripts\Graphs_Out\ben__benign_000043.pt,False,
benign_000471,0,1755,6157,101,8013,15127,C:\Users\Ali\Desktop\ChatGPT Scripts\Graphs_Out\ben__benign_000471.pt,False,
benign_000707,0,2221,7310,232,9763,15121,C:\Users\Ali\Desktop\ChatGPT Scripts\Graphs_Out\ben__benign_000707.pt,False,
benign_000973,0,1409,5711,39,7159,15107,C:\Users\Ali\Desktop\ChatGPT Scripts\Graphs_Out\ben__benign_000973.pt,False,
benign_000968,0,1578,6711,126,8415,15080,C:\Users\Ali\Desktop\ChatGPT Scripts\Graphs_Out\ben__benign_000968.pt,False,
benign_000975,0,1660,5092,49,6801,15077,C:\Users\Ali\Desktop\ChatGPT Scripts\Graphs_Out\ben__benign_000975.pt,False,
benign_000533,0,2827,5247,43,8117,15020,C:\Users\Ali\Desktop\ChatGPT Scripts\Graphs_Out\ben__benign_000533.pt,False,
benign_000054,0,2479,7275,175,9929,15018,C:\Users\Ali\Desktop\ChatGPT Scripts\Graphs_Out\ben__benign_000054.pt,False,
benign_000300,0,4055,4056,178,8289,15005,C:\Users\Ali\Desktop\ChatGPT Scripts\Graphs_Out\ben__benign_000300.pt,False,
benign_000735,0,1303,6433,103,7839,15003,C:\Users\Ali\Desktop\ChatGPT Scripts\Graphs_Out\ben__benign_000735.pt,False,
benign_000022,0,2618,8181,287,11086,14960,C:\Users\Ali\Desktop\ChatGPT Scripts\Graphs_Out\ben__benign_000022.pt,False,
benign_000412,0,1625,7125,289,9039,14959,C:\Users\Ali\Desktop\ChatGPT Scripts\Graphs_Out\ben__benign_000412.pt,False,
benign_000301,0,1517,6557,146,8220,14895,C:\Users\Ali\Desktop\ChatGPT Scripts\Graphs_Out\ben__benign_000301.pt,False,
benign_000458,0,1249,7066,91,8406,14873,C:\Users\Ali\Desktop\ChatGPT Scripts\Graphs_Out\ben__benign_000458.pt,False,
benign_000782,0,1551,6601,196,8348,14848,C:\Users\Ali\Desktop\ChatGPT Scripts\Graphs_Out\ben__benign_000782.pt,False,
benign_000964,0,787,12057,75,12919,14742,C:\Users\Ali\Desktop\ChatGPT Scripts\Graphs_Out\ben__benign_000964.pt,False,
benign_000586,0,2193,6616,125,8934,14739,C:\Users\Ali\Desktop\ChatGPT Scripts\Graphs_Out\ben__benign_000586.pt,False,
benign_000966,0,833,7106,48,7987,14719,C:\Users\Ali\Desktop\ChatGPT Scripts\Graphs_Out\ben__benign_000966.pt,False,
benign_000995,0,2032,5262,51,7345,14683,C:\Users\Ali\Desktop\ChatGPT Scripts\Graphs_Out\ben__benign_000995.pt,False,
benign_000691,0,2317,7108,198,9623,14677,C:\Users\Ali\Desktop\ChatGPT Scripts\Graphs_Out\ben__benign_000691.pt,False,
benign_000465,0,1499,6438,92,8029,14672,C:\Users\Ali\Desktop\ChatGPT Scripts\Graphs_Out\ben__benign_000465.pt,False,
benign_000622,0,2313,8446,182,10941,14656,C:\Users\Ali\Desktop\ChatGPT Scripts\Graphs_Out\ben__benign_000622.pt,False,
benign_000296,0,1421,7271,135,8827,14634,C:\Users\Ali\Desktop\ChatGPT Scripts\Graphs_Out\ben__benign_000296.pt,False,
benign_000903,0,3236,4014,46,7296,14623,C:\Users\Ali\Desktop\ChatGPT Scripts\Graphs_Out\ben__benign_000903.pt,False,
benign_000485,0,1557,6229,168,7954,14606,C:\Users\Ali\Desktop\ChatGPT Scripts\Graphs_Out\ben__benign_000485.pt,False,
benign_000948,0,716,11577,83,12376,14567,C:\Users\Ali\Desktop\ChatGPT Scripts\Graphs_Out\ben__benign_000948.pt,False,
benign_000055,0,2473,8816,104,11393,14557,C:\Users\Ali\Desktop\ChatGPT Scripts\Graphs_Out\ben__benign_000055.pt,False,
benign_000275,0,3471,4855,124,8450,14462,C:\Users\Ali\Desktop\ChatGPT Scripts\Graphs_Out\ben__benign_000275.pt,False,
benign_000051,0,2365,7551,113,10029,14442,C:\Users\Ali\Desktop\ChatGPT Scripts\Graphs_Out\ben__benign_000051.pt,False,
benign_000012,0,2775,7611,371,10757,14425,C:\Users\Ali\Desktop\ChatGPT Scripts\Graphs_Out\ben__benign_000012.pt,False,
benign_000758,0,2677,5974,158,8809,14424,C:\Users\Ali\Desktop\ChatGPT Scripts\Graphs_Out\ben__benign_000758.pt,False,
benign_000358,0,1593,6607,59,8259,14394,C:\Users\Ali\Desktop\ChatGPT Scripts\Graphs_Out\ben__benign_000358.pt,False,
benign_000529,0,2573,4825,39,7437,14312,C:\Users\Ali\Desktop\ChatGPT Scripts\Graphs_Out\ben__benign_000529.pt,False,
benign_000914,0,1146,5352,130,6628,14304,C:\Users\Ali\Desktop\ChatGPT Scripts\Graphs_Out\ben__benign_000914.pt,False,
benign_000311,0,2285,7617,724,10626,14262,C:\Users\Ali\Desktop\ChatGPT Scripts\Graphs_Out\ben__benign_000311.pt,False,
benign_000413,0,3655,5027,109,8791,14233,C:\Users\Ali\Desktop\ChatGPT Scripts\Graphs_Out\ben__benign_000413.pt,False,
benign_000360,0,1407,6204,185,7796,14120,C:\Users\Ali\Desktop\ChatGPT Scripts\Graphs_Out\ben__benign_000360.pt,False,
benign_000089,0,1286,7590,91,8967,14095,C:\Users\Ali\Desktop\ChatGPT Scripts\Graphs_Out\ben__benign_000089.pt,False,
benign_000354,0,1743,6007,133,7883,14091,C:\Users\Ali\Desktop\ChatGPT Scripts\Graphs_Out\ben__benign_000354.pt,False,
benign_000967,0,530,10157,38,10725,13996,C:\Users\Ali\Desktop\ChatGPT Scripts\Graphs_Out\ben__benign_000967.pt,False,
benign_000445,0,1534,6457,71,8062,13980,C:\Users\Ali\Desktop\ChatGPT Scripts\Graphs_Out\ben__benign_000445.pt,False,
benign_000391,0,2426,6612,185,9223,13957,C:\Users\Ali\Desktop\ChatGPT Scripts\Graphs_Out\ben__benign_000391.pt,False,
benign_000086,0,1534,6026,80,7640,13954,C:\Users\Ali\Desktop\ChatGPT Scripts\Graphs_Out\ben__benign_000086.pt,False,
benign_000342,0,3084,5245,89,8418,13913,C:\Users\Ali\Desktop\ChatGPT Scripts\Graphs_Out\ben__benign_000342.pt,False,
benign_000993,0,2254,5077,36,7367,13889,C:\Users\Ali\Desktop\ChatGPT Scripts\Graphs_Out\ben__benign_000993.pt,False,
benign_000375,0,1200,6713,84,7997,13885,C:\Users\Ali\Desktop\ChatGPT Scripts\Graphs_Out\ben__benign_000375.pt,False,
benign_000219,0,2081,7103,166,9350,13804,C:\Users\Ali\Desktop\ChatGPT Scripts\Graphs_Out\ben__benign_000219.pt,False,
benign_000482,0,1305,6403,122,7830,13783,C:\Users\Ali\Desktop\ChatGPT Scripts\Graphs_Out\ben__benign_000482.pt,False,
benign_000572,0,1752,4976,55,6783,13762,C:\Users\Ali\Desktop\ChatGPT Scripts\Graphs_Out\ben__benign_000572.pt,False,
benign_000527,0,2063,4916,61,7040,13712,C:\Users\Ali\Desktop\ChatGPT Scripts\Graphs_Out\ben__benign_000527.pt,False,
benign_000789,0,1242,5414,76,6732,13590,C:\Users\Ali\Desktop\ChatGPT Scripts\Graphs_Out\ben__benign_000789.pt,False,
benign_000659,0,1402,7320,183,8905,13587,C:\Users\Ali\Desktop\ChatGPT Scripts\Graphs_Out\ben__benign_000659.pt,False,
benign_000396,0,1283,8196,76,9555,13555,C:\Users\Ali\Desktop\ChatGPT Scripts\Graphs_Out\ben__benign_000396.pt,False,
benign_000544,0,1725,5162,174,7061,13552,C:\Users\Ali\Desktop\ChatGPT Scripts\Graphs_Out\ben__benign_000544.pt,False,
benign_000453,0,1308,5984,71,7363,13549,C:\Users\Ali\Desktop\ChatGPT Scripts\Graphs_Out\ben__benign_000453.pt,False,
benign_000684,0,2391,6178,230,8799,13468,C:\Users\Ali\Desktop\ChatGPT Scripts\Graphs_Out\ben__benign_000684.pt,False,
benign_000484,0,1490,6299,74,7863,13399,C:\Users\Ali\Desktop\ChatGPT Scripts\Graphs_Out\ben__benign_000484.pt,False,
benign_000507,0,1621,5165,84,6870,13382,C:\Users\Ali\Desktop\ChatGPT Scripts\Graphs_Out\ben__benign_000507.pt,False,
benign_000363,0,1218,6268,74,7560,13364,C:\Users\Ali\Desktop\ChatGPT Scripts\Graphs_Out\ben__benign_000363.pt,False,
benign_000516,0,2826,5022,46,7894,13174,C:\Users\Ali\Desktop\ChatGPT Scripts\Graphs_Out\ben__benign_000516.pt,False,
benign_000786,0,1033,5711,132,6876,13165,C:\Users\Ali\Desktop\ChatGPT Scripts\Graphs_Out\ben__benign_000786.pt,False,
benign_000364,0,1231,5990,98,7319,13092,C:\Users\Ali\Desktop\ChatGPT Scripts\Graphs_Out\ben__benign_000364.pt,False,
benign_000608,0,4465,4068,283,8816,13066,C:\Users\Ali\Desktop\ChatGPT Scripts\Graphs_Out\ben__benign_000608.pt,False,
benign_000001,0,5650,10758,106,16514,13060,C:\Users\Ali\Desktop\ChatGPT Scripts\Graphs_Out\ben__benign_000001.pt,False,
benign_000256,0,1158,6705,98,7961,13044,C:\Users\Ali\Desktop\ChatGPT Scripts\Graphs_Out\ben__benign_000256.pt,False,
benign_000383,0,1183,6067,98,7348,13005,C:\Users\Ali\Desktop\ChatGPT Scripts\Graphs_Out\ben__benign_000383.pt,False,
benign_000228,0,2349,5859,126,8334,13003,C:\Users\Ali\Desktop\ChatGPT Scripts\Graphs_Out\ben__benign_000228.pt,False,
benign_000472,0,1245,5288,100,6633,12983,C:\Users\Ali\Desktop\ChatGPT Scripts\Graphs_Out\ben__benign_000472.pt,False,
benign_000559,0,3370,3234,44,6648,12862,C:\Users\Ali\Desktop\ChatGPT Scripts\Graphs_Out\ben__benign_000559.pt,False,
benign_000837,0,1677,5017,75,6769,12859,C:\Users\Ali\Desktop\ChatGPT Scripts\Graphs_Out\ben__benign_000837.pt,False,
benign_000397,0,3541,4822,158,8521,12850,C:\Users\Ali\Desktop\ChatGPT Scripts\Graphs_Out\ben__benign_000397.pt,False,
benign_000456,0,1051,5767,60,6878,12818,C:\Users\Ali\Desktop\ChatGPT Scripts\Graphs_Out\ben__benign_000456.pt,False,
benign_000336,0,1772,4619,119,6510,12814,C:\Users\Ali\Desktop\ChatGPT Scripts\Graphs_Out\ben__benign_000336.pt,False,
benign_000288,0,2481,5645,71,8197,12739,C:\Users\Ali\Desktop\ChatGPT Scripts\Graphs_Out\ben__benign_000288.pt,False,
benign_000451,0,1066,5536,62,6664,12684,C:\Users\Ali\Desktop\ChatGPT Scripts\Graphs_Out\ben__benign_000451.pt,False,
benign_000561,0,2222,4111,34,6367,12667,C:\Users\Ali\Desktop\ChatGPT Scripts\Graphs_Out\ben__benign_000561.pt,False,
benign_000273,0,1019,5502,53,6574,12663,C:\Users\Ali\Desktop\ChatGPT Scripts\Graphs_Out\ben__benign_000273.pt,False,
benign_000757,0,2183,5390,93,7666,12621,C:\Users\Ali\Desktop\ChatGPT Scripts\Graphs_Out\ben__benign_000757.pt,False,
benign_000349,0,1399,5870,64,7333,12534,C:\Users\Ali\Desktop\ChatGPT Scripts\Graphs_Out\ben__benign_000349.pt,False,
benign_000928,0,3643,2822,47,6512,12438,C:\Users\Ali\Desktop\ChatGPT Scripts\Graphs_Out\ben__benign_000928.pt,False,
benign_000481,0,2936,4674,97,7707,12408,C:\Users\Ali\Desktop\ChatGPT Scripts\Graphs_Out\ben__benign_000481.pt,False,
benign_000855,0,2661,4197,44,6902,12375,C:\Users\Ali\Desktop\ChatGPT Scripts\Graphs_Out\ben__benign_000855.pt,False,
benign_000177,0,2010,6667,120,8797,12263,C:\Users\Ali\Desktop\ChatGPT Scripts\Graphs_Out\ben__benign_000177.pt,False,
benign_000970,0,982,5036,102,6120,12207,C:\Users\Ali\Desktop\ChatGPT Scripts\Graphs_Out\ben__benign_000970.pt,False,
benign_000673,0,2111,5489,121,7721,12171,C:\Users\Ali\Desktop\ChatGPT Scripts\Graphs_Out\ben__benign_000673.pt,False,
benign_000417,0,1778,6357,151,8286,12168,C:\Users\Ali\Desktop\ChatGPT Scripts\Graphs_Out\ben__benign_000417.pt,False,
benign_000613,0,1689,5537,821,8047,12144,C:\Users\Ali\Desktop\ChatGPT Scripts\Graphs_Out\ben__benign_000613.pt,False,
benign_000165,0,1908,6759,156,8823,11998,C:\Users\Ali\Desktop\ChatGPT Scripts\Graphs_Out\ben__benign_000165.pt,False,
benign_000161,0,1955,6277,109,8341,11870,C:\Users\Ali\Desktop\ChatGPT Scripts\Graphs_Out\ben__benign_000161.pt,False,
benign_000657,0,2021,5653,122,7796,11820,C:\Users\Ali\Desktop\ChatGPT Scripts\Graphs_Out\ben__benign_000657.pt,False,
benign_000164,0,1867,6400,108,8375,11805,C:\Users\Ali\Desktop\ChatGPT Scripts\Graphs_Out\ben__benign_000164.pt,False,
benign_000374,0,2108,4880,132,7120,11774,C:\Users\Ali\Desktop\ChatGPT Scripts\Graphs_Out\ben__benign_000374.pt,False,
benign_000124,0,2353,5500,109,7962,11736,C:\Users\Ali\Desktop\ChatGPT Scripts\Graphs_Out\ben__benign_000124.pt,False,
benign_000536,0,3747,2985,40,6772,11703,C:\Users\Ali\Desktop\ChatGPT Scripts\Graphs_Out\ben__benign_000536.pt,False,
benign_000169,0,1930,5624,99,7653,11687,C:\Users\Ali\Desktop\ChatGPT Scripts\Graphs_Out\ben__benign_000169.pt,False,
benign_000000,0,5487,10235,91,15813,11677,C:\Users\Ali\Desktop\ChatGPT Scripts\Graphs_Out\ben__benign_000000.pt,False,
benign_000512,0,1141,4624,44,5809,11636,C:\Users\Ali\Desktop\ChatGPT Scripts\Graphs_Out\ben__benign_000512.pt,False,
benign_000171,0,1822,6492,108,8422,11604,C:\Users\Ali\Desktop\ChatGPT Scripts\Graphs_Out\ben__benign_000171.pt,False,
benign_000015,0,1970,7269,190,9429,11602,C:\Users\Ali\Desktop\ChatGPT Scripts\Graphs_Out\ben__benign_000015.pt,False,
benign_000181,0,1806,6520,101,8427,11538,C:\Users\Ali\Desktop\ChatGPT Scripts\Graphs_Out\ben__benign_000181.pt,False,
benign_000814,0,800,4947,64,5811,11489,C:\Users\Ali\Desktop\ChatGPT Scripts\Graphs_Out\ben__benign_000814.pt,False,
benign_000244,0,2041,5762,150,7953,11443,C:\Users\Ali\Desktop\ChatGPT Scripts\Graphs_Out\ben__benign_000244.pt,False,
benign_000155,0,1756,6319,147,8222,11435,C:\Users\Ali\Desktop\ChatGPT Scripts\Graphs_Out\ben__benign_000155.pt,False,
benign_000157,0,1854,6718,111,8683,11433,C:\Users\Ali\Desktop\ChatGPT Scripts\Graphs_Out\ben__benign_000157.pt,False,
benign_000173,0,1822,5920,105,7847,11412,C:\Users\Ali\Desktop\ChatGPT Scripts\Graphs_Out\ben__benign_000173.pt,False,
benign_000962,0,1009,4346,36,5391,11388,C:\Users\Ali\Desktop\ChatGPT Scripts\Graphs_Out\ben__benign_000962.pt,False,
benign_000163,0,1785,6391,89,8265,11387,C:\Users\Ali\Desktop\ChatGPT Scripts\Graphs_Out\ben__benign_000163.pt,False,
benign_000180,0,1705,6391,147,8243,11378,C:\Users\Ali\Desktop\ChatGPT Scripts\Graphs_Out\ben__benign_000180.pt,False,
benign_000405,0,1883,5594,218,7695,11350,C:\Users\Ali\Desktop\ChatGPT Scripts\Graphs_Out\ben__benign_000405.pt,False,
benign_000935,0,1023,4140,38,5201,11319,C:\Users\Ali\Desktop\ChatGPT Scripts\Graphs_Out\ben__benign_000935.pt,False,
benign_000965,0,2946,3124,59,6129,11316,C:\Users\Ali\Desktop\ChatGPT Scripts\Graphs_Out\ben__benign_000965.pt,False,
benign_000168,0,1762,6387,74,8223,11248,C:\Users\Ali\Desktop\ChatGPT Scripts\Graphs_Out\ben__benign_000168.pt,False,
benign_000394,0,1436,5439,92,6967,11231,C:\Users\Ali\Desktop\ChatGPT Scripts\Graphs_Out\ben__benign_000394.pt,False,
benign_000933,0,824,4968,68,5860,11229,C:\Users\Ali\Desktop\ChatGPT Scripts\Graphs_Out\ben__benign_000933.pt,False,
benign_000156,0,1802,6009,102,7913,11204,C:\Users\Ali\Desktop\ChatGPT Scripts\Graphs_Out\ben__benign_000156.pt,False,
benign_000003,0,2045,7343,138,9526,11161,C:\Users\Ali\Desktop\ChatGPT Scripts\Graphs_Out\ben__benign_000003.pt,False,
benign_000002,0,1919,7679,152,9750,11148,C:\Users\Ali\Desktop\ChatGPT Scripts\Graphs_Out\ben__benign_000002.pt,False,
benign_000867,0,1207,4103,55,5365,11136,C:\Users\Ali\Desktop\ChatGPT Scripts\Graphs_Out\ben__benign_000867.pt,False,
benign_000160,0,1768,6637,116,8521,11070,C:\Users\Ali\Desktop\ChatGPT Scripts\Graphs_Out\ben__benign_000160.pt,False,
benign_000443,0,1620,5407,100,7127,11054,C:\Users\Ali\Desktop\ChatGPT Scripts\Graphs_Out\ben__benign_000443.pt,False,
benign_000953,0,2747,3130,44,5921,11019,C:\Users\Ali\Desktop\ChatGPT Scripts\Graphs_Out\ben__benign_000953.pt,False,
benign_000176,0,1709,6405,87,8201,11019,C:\Users\Ali\Desktop\ChatGPT Scripts\Graphs_Out\ben__benign_000176.pt,False,
benign_000167,0,1805,5395,96,7296,11017,C:\Users\Ali\Desktop\ChatGPT Scripts\Graphs_Out\ben__benign_000167.pt,False,
benign_000539,0,715,4860,40,5615,10995,C:\Users\Ali\Desktop\ChatGPT Scripts\Graphs_Out\ben__benign_000539.pt,False,
benign_000172,0,1556,6545,123,8224,10984,C:\Users\Ali\Desktop\ChatGPT Scripts\Graphs_Out\ben__benign_000172.pt,False,
benign_000424,0,2036,4804,128,6968,10960,C:\Users\Ali\Desktop\ChatGPT Scripts\Graphs_Out\ben__benign_000424.pt,False,
benign_000126,0,1924,5300,183,7407,10959,C:\Users\Ali\Desktop\ChatGPT Scripts\Graphs_Out\ben__benign_000126.pt,False,
benign_000159,0,1767,5871,106,7744,10959,C:\Users\Ali\Desktop\ChatGPT Scripts\Graphs_Out\ben__benign_000159.pt,False,
benign_000969,0,701,4230,55,4986,10938,C:\Users\Ali\Desktop\ChatGPT Scripts\Graphs_Out\ben__benign_000969.pt,False,
benign_000656,0,1598,5627,127,7352,10848,C:\Users\Ali\Desktop\ChatGPT Scripts\Graphs_Out\ben__benign_000656.pt,False,
benign_000568,0,3729,2150,40,5919,10840,C:\Users\Ali\Desktop\ChatGPT Scripts\Graphs_Out\ben__benign_000568.pt,False,
benign_000175,0,1587,5929,126,7642,10837,C:\Users\Ali\Desktop\ChatGPT Scripts\Graphs_Out\ben__benign_000175.pt,False,
benign_000524,0,802,4478,100,5380,10821,C:\Users\Ali\Desktop\ChatGPT Scripts\Graphs_Out\ben__benign_000524.pt,False,
benign_000668,0,1849,4948,119,6916,10787,C:\Users\Ali\Desktop\ChatGPT Scripts\Graphs_Out\ben__benign_000668.pt,False,
benign_000817,0,836,4491,61,5388,10774,C:\Users\Ali\Desktop\ChatGPT Scripts\Graphs_Out\ben__benign_000817.pt,False,
benign_000922,0,807,4040,69,4916,10732,C:\Users\Ali\Desktop\ChatGPT Scripts\Graphs_Out\ben__benign_000922.pt,False,
benign_000513,0,841,4459,44,5344,10730,C:\Users\Ali\Desktop\ChatGPT Scripts\Graphs_Out\ben__benign_000513.pt,False,
benign_000761,0,1340,4609,106,6055,10721,C:\Users\Ali\Desktop\ChatGPT Scripts\Graphs_Out\ben__benign_000761.pt,False,
benign_000298,0,1524,5134,55,6713,10714,C:\Users\Ali\Desktop\ChatGPT Scripts\Graphs_Out\ben__benign_000298.pt,False,
benign_000188,0,1830,5993,114,7937,10697,C:\Users\Ali\Desktop\ChatGPT Scripts\Graphs_Out\ben__benign_000188.pt,False,
benign_000730,0,1929,4698,126,6753,10696,C:\Users\Ali\Desktop\ChatGPT Scripts\Graphs_Out\ben__benign_000730.pt,False,
benign_000183,0,1719,5503,120,7342,10687,C:\Users\Ali\Desktop\ChatGPT Scripts\Graphs_Out\ben__benign_000183.pt,False,
benign_000179,0,1637,5301,129,7067,10650,C:\Users\Ali\Desktop\ChatGPT Scripts\Graphs_Out\ben__benign_000179.pt,False,
benign_000514,0,796,4699,96,5591,10646,C:\Users\Ali\Desktop\ChatGPT Scripts\Graphs_Out\ben__benign_000514.pt,False,
benign_000765,0,1891,4743,150,6784,10641,C:\Users\Ali\Desktop\ChatGPT Scripts\Graphs_Out\ben__benign_000765.pt,False,
benign_000739,0,1636,4706,126,6468,10631,C:\Users\Ali\Desktop\ChatGPT Scripts\Graphs_Out\ben__benign_000739.pt,False,
benign_000629,0,2019,4898,128,7045,10568,C:\Users\Ali\Desktop\ChatGPT Scripts\Graphs_Out\ben__benign_000629.pt,False,
benign_000816,0,1057,3897,81,5035,10559,C:\Users\Ali\Desktop\ChatGPT Scripts\Graphs_Out\ben__benign_000816.pt,False,
benign_000537,0,623,4312,45,4980,10531,C:\Users\Ali\Desktop\ChatGPT Scripts\Graphs_Out\ben__benign_000537.pt,False,
benign_000835,0,830,3950,96,4876,10522,C:\Users\Ali\Desktop\ChatGPT Scripts\Graphs_Out\ben__benign_000835.pt,False,
benign_000538,0,672,4397,34,5103,10504,C:\Users\Ali\Desktop\ChatGPT Scripts\Graphs_Out\ben__benign_000538.pt,False,
benign_000875,0,791,3946,42,4779,10480,C:\Users\Ali\Desktop\ChatGPT Scripts\Graphs_Out\ben__benign_000875.pt,False,
benign_000763,0,2076,4338,93,6507,10406,C:\Users\Ali\Desktop\ChatGPT Scripts\Graphs_Out\ben__benign_000763.pt,False,
benign_000574,0,731,3978,39,4748,10372,C:\Users\Ali\Desktop\ChatGPT Scripts\Graphs_Out\ben__benign_000574.pt,False,
benign_000184,0,1724,4901,102,6727,10332,C:\Users\Ali\Desktop\ChatGPT Scripts\Graphs_Out\ben__benign_000184.pt,False,
benign_000746,0,1907,4734,98,6739,10324,C:\Users\Ali\Desktop\ChatGPT Scripts\Graphs_Out\ben__benign_000746.pt,False,
benign_000392,0,1946,4430,139,6515,10307,C:\Users\Ali\Desktop\ChatGPT Scripts\Graphs_Out\ben__benign_000392.pt,False,
benign_000528,0,773,4140,48,4961,10277,C:\Users\Ali\Desktop\ChatGPT Scripts\Graphs_Out\ben__benign_000528.pt,False,
benign_000926,0,638,5152,50,5840,10252,C:\Users\Ali\Desktop\ChatGPT Scripts\Graphs_Out\ben__benign_000926.pt,False,
benign_000122,0,1694,5879,180,7753,10220,C:\Users\Ali\Desktop\ChatGPT Scripts\Graphs_Out\ben__benign_000122.pt,False,
benign_000293,0,1399,5286,123,6808,10203,C:\Users\Ali\Desktop\ChatGPT Scripts\Graphs_Out\ben__benign_000293.pt,False,
benign_000958,0,805,3742,40,4587,10145,C:\Users\Ali\Desktop\ChatGPT Scripts\Graphs_Out\ben__benign_000958.pt,False,
benign_000503,0,1994,4780,118,6892,10145,C:\Users\Ali\Desktop\ChatGPT Scripts\Graphs_Out\ben__benign_000503.pt,False,
benign_000921,0,815,3712,42,4569,10125,C:\Users\Ali\Desktop\ChatGPT Scripts\Graphs_Out\ben__benign_000921.pt,False,
benign_000755,0,1632,4431,113,6176,10111,C:\Users\Ali\Desktop\ChatGPT Scripts\Graphs_Out\ben__benign_000755.pt,False,
benign_000941,0,771,3757,35,4563,10089,C:\Users\Ali\Desktop\ChatGPT Scripts\Graphs_Out\ben__benign_000941.pt,False,
benign_000802,0,1258,4596,104,5958,10078,C:\Users\Ali\Desktop\ChatGPT Scripts\Graphs_Out\ben__benign_000802.pt,False,
benign_000543,0,633,4380,37,5050,10066,C:\Users\Ali\Desktop\ChatGPT Scripts\Graphs_Out\ben__benign_000543.pt,False,
benign_000628,0,1572,5374,106,7052,10049,C:\Users\Ali\Desktop\ChatGPT Scripts\Graphs_Out\ben__benign_000628.pt,False,
benign_000480,0,1970,4380,201,6551,10046,C:\Users\Ali\Desktop\ChatGPT Scripts\Graphs_Out\ben__benign_000480.pt,False,
benign_000535,0,635,4297,59,4991,10039,C:\Users\Ali\Desktop\ChatGPT Scripts\Graphs_Out\ben__benign_000535.pt,False,
benign_000356,0,2036,4415,96,6547,10034,C:\Users\Ali\Desktop\ChatGPT Scripts\Graphs_Out\ben__benign_000356.pt,False,
benign_000229,0,1478,5254,86,6818,10025,C:\Users\Ali\Desktop\ChatGPT Scripts\Graphs_Out\ben__benign_000229.pt,False,
benign_000187,0,1493,5680,130,7303,10002,C:\Users\Ali\Desktop\ChatGPT Scripts\Graphs_Out\ben__benign_000187.pt,False,
benign_000919,0,616,3987,57,4660,9993,C:\Users\Ali\Desktop\ChatGPT Scripts\Graphs_Out\ben__benign_000919.pt,False,
benign_000961,0,649,4021,41,4711,9983,C:\Users\Ali\Desktop\ChatGPT Scripts\Graphs_Out\ben__benign_000961.pt,False,
benign_000462,0,2056,3816,74,5946,9971,C:\Users\Ali\Desktop\ChatGPT Scripts\Graphs_Out\ben__benign_000462.pt,False,
benign_000508,0,676,4962,35,5673,9963,C:\Users\Ali\Desktop\ChatGPT Scripts\Graphs_Out\ben__benign_000508.pt,False,
benign_000612,0,1466,5208,217,6891,9926,C:\Users\Ali\Desktop\ChatGPT Scripts\Graphs_Out\ben__benign_000612.pt,False,
benign_000340,0,855,4632,40,5527,9923,C:\Users\Ali\Desktop\ChatGPT Scripts\Graphs_Out\ben__benign_000340.pt,False,
benign_000104,0,2157,8554,121,10832,9913,C:\Users\Ali\Desktop\ChatGPT Scripts\Graphs_Out\ben__benign_000104.pt,False,
benign_000793,0,1132,4585,193,5910,9889,C:\Users\Ali\Desktop\ChatGPT Scripts\Graphs_Out\ben__benign_000793.pt,False,
benign_000828,0,655,3829,45,4529,9888,C:\Users\Ali\Desktop\ChatGPT Scripts\Graphs_Out\ben__benign_000828.pt,False,
benign_000525,0,3036,2436,52,5524,9882,C:\Users\Ali\Desktop\ChatGPT Scripts\Graphs_Out\ben__benign_000525.pt,False,
benign_000734,0,1573,4546,133,6252,9879,C:\Users\Ali\Desktop\ChatGPT Scripts\Graphs_Out\ben__benign_000734.pt,False,
benign_000350,0,1627,4512,81,6220,9834,C:\Users\Ali\Desktop\ChatGPT Scripts\Graphs_Out\ben__benign_000350.pt,False,
benign_000900,0,619,4208,58,4885,9820,C:\Users\Ali\Desktop\ChatGPT Scripts\Graphs_Out\ben__benign_000900.pt,False,
benign_000737,0,1547,4282,101,5930,9819,C:\Users\Ali\Desktop\ChatGPT Scripts\Graphs_Out\ben__benign_000737.pt,False,
benign_000534,0,2903,2506,47,5456,9814,C:\Users\Ali\Desktop\ChatGPT Scripts\Graphs_Out\ben__benign_000534.pt,False,
benign_000839,0,721,3795,42,4558,9811,C:\Users\Ali\Desktop\ChatGPT Scripts\Graphs_Out\ben__benign_000839.pt,False,
benign_000550,0,629,4080,36,4745,9785,C:\Users\Ali\Desktop\ChatGPT Scripts\Graphs_Out\ben__benign_000550.pt,False,
benign_000924,0,625,4028,65,4718,9767,C:\Users\Ali\Desktop\ChatGPT Scripts\Graphs_Out\ben__benign_000924.pt,False,
benign_000997,0,567,3795,57,4419,9726,C:\Users\Ali\Desktop\ChatGPT Scripts\Graphs_Out\ben__benign_000997.pt,False,
benign_000963,0,720,3642,37,4399,9715,C:\Users\Ali\Desktop\ChatGPT Scripts\Graphs_Out\ben__benign_000963.pt,False,
benign_000844,0,628,4022,36,4686,9680,C:\Users\Ali\Desktop\ChatGPT Scripts\Graphs_Out\ben__benign_000844.pt,False,
benign_000433,0,1201,4942,627,6770,9656,C:\Users\Ali\Desktop\ChatGPT Scripts\Graphs_Out\ben__benign_000433.pt,False,
benign_000747,0,1714,4016,85,5815,9632,C:\Users\Ali\Desktop\ChatGPT Scripts\Graphs_Out\ben__benign_000747.pt,False,
benign_000344,0,1941,4722,80,6743,9621,C:\Users\Ali\Desktop\ChatGPT Scripts\Graphs_Out\ben__benign_000344.pt,False,
benign_000280,0,1625,4168,75,5868,9607,C:\Users\Ali\Desktop\ChatGPT Scripts\Graphs_Out\ben__benign_000280.pt,False,
benign_000557,0,2740,2637,41,5418,9589,C:\Users\Ali\Desktop\ChatGPT Scripts\Graphs_Out\ben__benign_000557.pt,False,
benign_000523,0,729,4244,73,5046,9513,C:\Users\Ali\Desktop\ChatGPT Scripts\Graphs_Out\ben__benign_000523.pt,False,
benign_000474,0,1911,4171,59,6141,9475,C:\Users\Ali\Desktop\ChatGPT Scripts\Graphs_Out\ben__benign_000474.pt,False,
benign_000860,0,550,3758,32,4340,9424,C:\Users\Ali\Desktop\ChatGPT Scripts\Graphs_Out\ben__benign_000860.pt,False,
benign_000460,0,1097,4675,62,5834,9399,C:\Users\Ali\Desktop\ChatGPT Scripts\Graphs_Out\ben__benign_000460.pt,False,
benign_000936,0,509,3845,40,4394,9371,C:\Users\Ali\Desktop\ChatGPT Scripts\Graphs_Out\ben__benign_000936.pt,False,
benign_000584,0,1626,5304,127,7057,9349,C:\Users\Ali\Desktop\ChatGPT Scripts\Graphs_Out\ben__benign_000584.pt,False,
benign_000870,0,1387,4238,112,5737,9172,C:\Users\Ali\Desktop\ChatGPT Scripts\Graphs_Out\ben__benign_000870.pt,False,
benign_000478,0,1606,4231,108,5945,9143,C:\Users\Ali\Desktop\ChatGPT Scripts\Graphs_Out\ben__benign_000478.pt,False,
benign_000459,0,1973,3623,83,5679,9075,C:\Users\Ali\Desktop\ChatGPT Scripts\Graphs_Out\ben__benign_000459.pt,False,
benign_000065,0,1669,4865,87,6621,9071,C:\Users\Ali\Desktop\ChatGPT Scripts\Graphs_Out\ben__benign_000065.pt,False,
benign_000092,0,1395,4836,109,6340,9069,C:\Users\Ali\Desktop\ChatGPT Scripts\Graphs_Out\ben__benign_000092.pt,False,
benign_000259,0,1155,3778,53,4986,9039,C:\Users\Ali\Desktop\ChatGPT Scripts\Graphs_Out\ben__benign_000259.pt,False,
benign_000463,0,1684,3722,294,5700,9031,C:\Users\Ali\Desktop\ChatGPT Scripts\Graphs_Out\ben__benign_000463.pt,False,
benign_000506,0,761,5118,58,5937,9019,C:\Users\Ali\Desktop\ChatGPT Scripts\Graphs_Out\ben__benign_000506.pt,False,
benign_000750,0,1318,4423,74,5815,8934,C:\Users\Ali\Desktop\ChatGPT Scripts\Graphs_Out\ben__benign_000750.pt,False,
benign_000371,0,1626,4101,116,5843,8856,C:\Users\Ali\Desktop\ChatGPT Scripts\Graphs_Out\ben__benign_000371.pt,False,
benign_000133,0,1344,5056,100,6500,8853,C:\Users\Ali\Desktop\ChatGPT Scripts\Graphs_Out\ben__benign_000133.pt,False,
benign_000477,0,1807,3786,84,5677,8822,C:\Users\Ali\Desktop\ChatGPT Scripts\Graphs_Out\ben__benign_000477.pt,False,
benign_000501,0,1408,4239,95,5742,8801,C:\Users\Ali\Desktop\ChatGPT Scripts\Graphs_Out\ben__benign_000501.pt,False,
benign_000575,0,825,4181,72,5078,8793,C:\Users\Ali\Desktop\ChatGPT Scripts\Graphs_Out\ben__benign_000575.pt,False,
benign_000081,0,1642,3916,83,5641,8686,C:\Users\Ali\Desktop\ChatGPT Scripts\Graphs_Out\ben__benign_000081.pt,False,
benign_000132,0,1403,4628,113,6144,8681,C:\Users\Ali\Desktop\ChatGPT Scripts\Graphs_Out\ben__benign_000132.pt,False,
benign_000504,0,2076,3286,84,5446,8668,C:\Users\Ali\Desktop\ChatGPT Scripts\Graphs_Out\ben__benign_000504.pt,False,
benign_000083,0,1399,4705,100,6204,8667,C:\Users\Ali\Desktop\ChatGPT Scripts\Graphs_Out\ben__benign_000083.pt,False,
benign_000432,0,1582,3897,134,5613,8619,C:\Users\Ali\Desktop\ChatGPT Scripts\Graphs_Out\ben__benign_000432.pt,False,
benign_000357,0,1526,3808,126,5460,8597,C:\Users\Ali\Desktop\ChatGPT Scripts\Graphs_Out\ben__benign_000357.pt,False,
benign_000345,0,1453,4049,197,5699,8595,C:\Users\Ali\Desktop\ChatGPT Scripts\Graphs_Out\ben__benign_000345.pt,False,
benign_000090,0,1309,4826,94,6229,8593,C:\Users\Ali\Desktop\ChatGPT Scripts\Graphs_Out\ben__benign_000090.pt,False,
benign_000138,0,1306,4659,84,6049,8579,C:\Users\Ali\Desktop\ChatGPT Scripts\Graphs_Out\ben__benign_000138.pt,False,
benign_000731,0,1266,4218,88,5572,8525,C:\Users\Ali\Desktop\ChatGPT Scripts\Graphs_Out\ben__benign_000731.pt,False,
benign_000381,0,1264,4223,102,5589,8505,C:\Users\Ali\Desktop\ChatGPT Scripts\Graphs_Out\ben__benign_000381.pt,False,
benign_000134,0,1355,4408,145,5908,8491,C:\Users\Ali\Desktop\ChatGPT Scripts\Graphs_Out\ben__benign_000134.pt,False,
benign_000074,0,1473,4830,63,6366,8472,C:\Users\Ali\Desktop\ChatGPT Scripts\Graphs_Out\ben__benign_000074.pt,False,
benign_000130,0,1304,4633,108,6045,8457,C:\Users\Ali\Desktop\ChatGPT Scripts\Graphs_Out\ben__benign_000130.pt,False,
benign_000253,0,1708,3560,155,5423,8402,C:\Users\Ali\Desktop\ChatGPT Scripts\Graphs_Out\ben__benign_000253.pt,False,
benign_000084,0,1178,4941,73,6192,8380,C:\Users\Ali\Desktop\ChatGPT Scripts\Graphs_Out\ben__benign_000084.pt,False,
benign_000147,0,1432,4166,60,5658,8369,C:\Users\Ali\Desktop\ChatGPT Scripts\Graphs_Out\ben__benign_000147.pt,False,
benign_000145,0,1162,4670,69,5901,8365,C:\Users\Ali\Desktop\ChatGPT Scripts\Graphs_Out\ben__benign_000145.pt,False,
benign_000129,0,1252,4737,90,6079,8344,C:\Users\Ali\Desktop\ChatGPT Scripts\Graphs_Out\ben__benign_000129.pt,False,
benign_000128,0,1299,4676,104,6079,8327,C:\Users\Ali\Desktop\ChatGPT Scripts\Graphs_Out\ben__benign_000128.pt,False,
benign_000314,0,1423,4459,265,6147,8307,C:\Users\Ali\Desktop\ChatGPT Scripts\Graphs_Out\ben__benign_000314.pt,False,
benign_000064,0,1367,4849,108,6324,8295,C:\Users\Ali\Desktop\ChatGPT Scripts\Graphs_Out\ben__benign_000064.pt,False,
benign_000142,0,1308,4258,82,5648,8289,C:\Users\Ali\Desktop\ChatGPT Scripts\Graphs_Out\ben__benign_000142.pt,False,
benign_000382,0,1460,3565,161,5186,8266,C:\Users\Ali\Desktop\ChatGPT Scripts\Graphs_Out\ben__benign_000382.pt,False,
benign_000400,0,1487,4282,84,5853,8212,C:\Users\Ali\Desktop\ChatGPT Scripts\Graphs_Out\ben__benign_000400.pt,False,
benign_000069,0,1563,3974,150,5687,8205,C:\Users\Ali\Desktop\ChatGPT Scripts\Graphs_Out\ben__benign_000069.pt,False,
benign_000136,0,1281,4258,109,5648,8195,C:\Users\Ali\Desktop\ChatGPT Scripts\Graphs_Out\ben__benign_000136.pt,False,
benign_000353,0,1652,3828,53,5533,8174,C:\Users\Ali\Desktop\ChatGPT Scripts\Graphs_Out\ben__benign_000353.pt,False,
benign_000146,0,1235,4146,68,5449,8160,C:\Users\Ali\Desktop\ChatGPT Scripts\Graphs_Out\ben__benign_000146.pt,False,
benign_000437,0,1472,3756,91,5319,8157,C:\Users\Ali\Desktop\ChatGPT Scripts\Graphs_Out\ben__benign_000437.pt,False,
benign_000144,0,1150,4332,76,5558,8133,C:\Users\Ali\Desktop\ChatGPT Scripts\Graphs_Out\ben__benign_000144.pt,False,
benign_000267,0,1958,3709,70,5737,8133,C:\Users\Ali\Desktop\ChatGPT Scripts\Graphs_Out\ben__benign_000267.pt,False,
benign_000373,0,1498,3699,133,5330,8094,C:\Users\Ali\Desktop\ChatGPT Scripts\Graphs_Out\ben__benign_000373.pt,False,
benign_000152,0,1159,5105,87,6351,8086,C:\Users\Ali\Desktop\ChatGPT Scripts\Graphs_Out\ben__benign_000152.pt,False,
benign_000380,0,1523,3774,64,5361,8069,C:\Users\Ali\Desktop\ChatGPT Scripts\Graphs_Out\ben__benign_000380.pt,False,
benign_000135,0,1073,4742,70,5885,8067,C:\Users\Ali\Desktop\ChatGPT Scripts\Graphs_Out\ben__benign_000135.pt,False,
benign_000140,0,1072,4927,71,6070,8057,C:\Users\Ali\Desktop\ChatGPT Scripts\Graphs_Out\ben__benign_000140.pt,False,
benign_000988,0,1822,2308,381,4511,8050,C:\Users\Ali\Desktop\ChatGPT Scripts\Graphs_Out\ben__benign_000988.pt,False,
benign_000151,0,1142,4680,80,5902,8021,C:\Users\Ali\Desktop\ChatGPT Scripts\Graphs_Out\ben__benign_000151.pt,False,
benign_000435,0,1156,4433,61,5650,7999,C:\Users\Ali\Desktop\ChatGPT Scripts\Graphs_Out\ben__benign_000435.pt,False,
benign_000899,0,681,3371,70,4122,7987,C:\Users\Ali\Desktop\ChatGPT Scripts\Graphs_Out\ben__benign_000899.pt,False,
benign_000063,0,1940,4040,70,6050,7985,C:\Users\Ali\Desktop\ChatGPT Scripts\Graphs_Out\ben__benign_000063.pt,False,
benign_000078,0,1273,4152,73,5498,7965,C:\Users\Ali\Desktop\ChatGPT Scripts\Graphs_Out\ben__benign_000078.pt,False,
benign_000072,0,1230,4568,91,5889,7962,C:\Users\Ali\Desktop\ChatGPT Scripts\Graphs_Out\ben__benign_000072.pt,False,
benign_000141,0,1107,4713,95,5915,7944,C:\Users\Ali\Desktop\ChatGPT Scripts\Graphs_Out\ben__benign_000141.pt,False,
benign_000068,0,1462,3876,87,5425,7932,C:\Users\Ali\Desktop\ChatGPT Scripts\Graphs_Out\ben__benign_000068.pt,False,
benign_000153,0,1160,4548,73,5781,7916,C:\Users\Ali\Desktop\ChatGPT Scripts\Graphs_Out\ben__benign_000153.pt,False,
benign_000131,0,1096,4324,94,5514,7915,C:\Users\Ali\Desktop\ChatGPT Scripts\Graphs_Out\ben__benign_000131.pt,False,
benign_000127,0,1098,4475,56,5629,7907,C:\Users\Ali\Desktop\ChatGPT Scripts\Graphs_Out\ben__benign_000127.pt,False,
benign_000927,0,2094,2030,36,4160,7904,C:\Users\Ali\Desktop\ChatGPT Scripts\Graphs_Out\ben__benign_000927.pt,False,
benign_000066,0,1253,4595,81,5929,7852,C:\Users\Ali\Desktop\ChatGPT Scripts\Graphs_Out\ben__benign_000066.pt,False,
benign_000079,0,1269,4231,95,5595,7846,C:\Users\Ali\Desktop\ChatGPT Scripts\Graphs_Out\ben__benign_000079.pt,False,
benign_000139,0,1081,4835,81,5997,7830,C:\Users\Ali\Desktop\ChatGPT Scripts\Graphs_Out\ben__benign_000139.pt,False,
benign_000148,0,1099,4154,82,5335,7809,C:\Users\Ali\Desktop\ChatGPT Scripts\Graphs_Out\ben__benign_000148.pt,False,
benign_000143,0,1113,4422,63,5598,7808,C:\Users\Ali\Desktop\ChatGPT Scripts\Graphs_Out\ben__benign_000143.pt,False,
benign_000073,0,1294,4178,79,5551,7796,C:\Users\Ali\Desktop\ChatGPT Scripts\Graphs_Out\ben__benign_000073.pt,False,
benign_000077,0,1219,4433,55,5707,7796,C:\Users\Ali\Desktop\ChatGPT Scripts\Graphs_Out\ben__benign_000077.pt,False,
benign_000304,0,1126,3212,34,4372,7793,C:\Users\Ali\Desktop\ChatGPT Scripts\Graphs_Out\ben__benign_000304.pt,False,
benign_000473,0,1221,3937,91,5249,7747,C:\Users\Ali\Desktop\ChatGPT Scripts\Graphs_Out\ben__benign_000473.pt,False,
benign_000137,0,1157,4319,56,5532,7743,C:\Users\Ali\Desktop\ChatGPT Scripts\Graphs_Out\ben__benign_000137.pt,False,
benign_000461,0,2138,3182,93,5413,7735,C:\Users\Ali\Desktop\ChatGPT Scripts\Graphs_Out\ben__benign_000461.pt,False,
benign_000150,0,1082,4322,61,5465,7732,C:\Users\Ali\Desktop\ChatGPT Scripts\Graphs_Out\ben__benign_000150.pt,False,
benign_000379,0,1477,3397,119,4993,7705,C:\Users\Ali\Desktop\ChatGPT Scripts\Graphs_Out\ben__benign_000379.pt,False,
benign_000277,0,1327,3377,78,4782,7675,C:\Users\Ali\Desktop\ChatGPT Scripts\Graphs_Out\ben__benign_000277.pt,False,
benign_000149,0,1084,4028,59,5171,7667,C:\Users\Ali\Desktop\ChatGPT Scripts\Graphs_Out\ben__benign_000149.pt,False,
benign_000087,0,1368,3856,92,5316,7666,C:\Users\Ali\Desktop\ChatGPT Scripts\Graphs_Out\ben__benign_000087.pt,False,
benign_000346,0,1255,3598,135,4988,7647,C:\Users\Ali\Desktop\ChatGPT Scripts\Graphs_Out\ben__benign_000346.pt,False,
benign_000061,0,1332,3831,102,5265,7610,C:\Users\Ali\Desktop\ChatGPT Scripts\Graphs_Out\ben__benign_000061.pt,False,
benign_000517,0,632,3499,39,4170,7541,C:\Users\Ali\Desktop\ChatGPT Scripts\Graphs_Out\ben__benign_000517.pt,False,
benign_000343,0,1255,3428,96,4779,7538,C:\Users\Ali\Desktop\ChatGPT Scripts\Graphs_Out\ben__benign_000343.pt,False,
benign_000369,0,1416,3249,113,4778,7527,C:\Users\Ali\Desktop\ChatGPT Scripts\Graphs_Out\ben__benign_000369.pt,False,
benign_000457,0,1198,3340,86,4624,7495,C:\Users\Ali\Desktop\ChatGPT Scripts\Graphs_Out\ben__benign_000457.pt,False,
benign_000497,0,1799,3326,108,5233,7492,C:\Users\Ali\Desktop\ChatGPT Scripts\Graphs_Out\ben__benign_000497.pt,False,
benign_000440,0,1371,3566,72,5009,7474,C:\Users\Ali\Desktop\ChatGPT Scripts\Graphs_Out\ben__benign_000440.pt,False,
benign_000476,0,1486,3348,59,4893,7464,C:\Users\Ali\Desktop\ChatGPT Scripts\Graphs_Out\ben__benign_000476.pt,False,
benign_000384,0,1297,3590,109,4996,7455,C:\Users\Ali\Desktop\ChatGPT Scripts\Graphs_Out\ben__benign_000384.pt,False,
benign_000305,0,781,3327,87,4195,7431,C:\Users\Ali\Desktop\ChatGPT Scripts\Graphs_Out\ben__benign_000305.pt,False,
benign_000279,0,1129,3793,53,4975,7427,C:\Users\Ali\Desktop\ChatGPT Scripts\Graphs_Out\ben__benign_000279.pt,False,
benign_000348,0,1215,3483,87,4785,7425,C:\Users\Ali\Desktop\ChatGPT Scripts\Graphs_Out\ben__benign_000348.pt,False,
benign_000355,0,1048,3796,108,4952,7386,C:\Users\Ali\Desktop\ChatGPT Scripts\Graphs_Out\ben__benign_000355.pt,False,
benign_000075,0,1122,4122,96,5340,7339,C:\Users\Ali\Desktop\ChatGPT Scripts\Graphs_Out\ben__benign_000075.pt,False,
benign_000376,0,1327,2902,166,4395,7302,C:\Users\Ali\Desktop\ChatGPT Scripts\Graphs_Out\ben__benign_000376.pt,False,
benign_000840,0,512,3952,40,4504,7264,C:\Users\Ali\Desktop\ChatGPT Scripts\Graphs_Out\ben__benign_000840.pt,False,
benign_000088,0,1181,4092,114,5387,7218,C:\Users\Ali\Desktop\ChatGPT Scripts\Graphs_Out\ben__benign_000088.pt,False,
benign_000085,0,1133,4114,78,5325,7213,C:\Users\Ali\Desktop\ChatGPT Scripts\Graphs_Out\ben__benign_000085.pt,False,
benign_000809,0,1012,3508,108,4628,7200,C:\Users\Ali\Desktop\ChatGPT Scripts\Graphs_Out\ben__benign_000809.pt,False,
benign_000372,0,1152,3609,92,4853,7169,C:\Users\Ali\Desktop\ChatGPT Scripts\Graphs_Out\ben__benign_000372.pt,False,
benign_000931,0,543,2959,71,3573,7120,C:\Users\Ali\Desktop\ChatGPT Scripts\Graphs_Out\ben__benign_000931.pt,False,
benign_000276,0,1067,3860,98,5025,7110,C:\Users\Ali\Desktop\ChatGPT Scripts\Graphs_Out\ben__benign_000276.pt,False,
benign_000377,0,1059,3728,63,4850,6994,C:\Users\Ali\Desktop\ChatGPT Scripts\Graphs_Out\ben__benign_000377.pt,False,
benign_000578,0,1192,4368,58,5618,6956,C:\Users\Ali\Desktop\ChatGPT Scripts\Graphs_Out\ben__benign_000578.pt,False,
benign_000303,0,935,1981,1259,4175,6947,C:\Users\Ali\Desktop\ChatGPT Scripts\Graphs_Out\ben__benign_000303.pt,False,
benign_000368,0,1121,3432,100,4653,6937,C:\Users\Ali\Desktop\ChatGPT Scripts\Graphs_Out\ben__benign_000368.pt,False,
benign_000018,0,1286,4211,102,5599,6937,C:\Users\Ali\Desktop\ChatGPT Scripts\Graphs_Out\ben__benign_000018.pt,False,
benign_000281,0,1075,3101,72,4248,6884,C:\Users\Ali\Desktop\ChatGPT Scripts\Graphs_Out\ben__benign_000281.pt,False,
benign_000255,0,1124,2964,154,4242,6838,C:\Users\Ali\Desktop\ChatGPT Scripts\Graphs_Out\ben__benign_000255.pt,False,
benign_000519,0,697,2980,35,3712,6817,C:\Users\Ali\Desktop\ChatGPT Scripts\Graphs_Out\ben__benign_000519.pt,False,
benign_000466,0,1043,3132,48,4223,6786,C:\Users\Ali\Desktop\ChatGPT Scripts\Graphs_Out\ben__benign_000466.pt,False,
benign_000286,0,1068,3355,53,4476,6730,C:\Users\Ali\Desktop\ChatGPT Scripts\Graphs_Out\ben__benign_000286.pt,False,
benign_000359,0,1560,3339,47,4946,6716,C:\Users\Ali\Desktop\ChatGPT Scripts\Graphs_Out\ben__benign_000359.pt,False,
benign_000475,0,995,3478,60,4533,6674,C:\Users\Ali\Desktop\ChatGPT Scripts\Graphs_Out\ben__benign_000475.pt,False,
benign_000082,0,1053,3478,74,4605,6660,C:\Users\Ali\Desktop\ChatGPT Scripts\Graphs_Out\ben__benign_000082.pt,False,
benign_000448,0,1203,2907,47,4157,6654,C:\Users\Ali\Desktop\ChatGPT Scripts\Graphs_Out\ben__benign_000448.pt,False,
benign_000971,0,764,2843,331,3938,6623,C:\Users\Ali\Desktop\ChatGPT Scripts\Graphs_Out\ben__benign_000971.pt,False,
benign_000285,0,1142,2890,85,4117,6593,C:\Users\Ali\Desktop\ChatGPT Scripts\Graphs_Out\ben__benign_000285.pt,False,
benign_000302,0,529,3160,69,3758,6567,C:\Users\Ali\Desktop\ChatGPT Scripts\Graphs_Out\ben__benign_000302.pt,False,
benign_000291,0,1221,2907,63,4191,6538,C:\Users\Ali\Desktop\ChatGPT Scripts\Graphs_Out\ben__benign_000291.pt,False,
benign_000278,0,1024,2989,57,4070,6458,C:\Users\Ali\Desktop\ChatGPT Scripts\Graphs_Out\ben__benign_000278.pt,False,
benign_000282,0,1076,3254,58,4388,6432,C:\Users\Ali\Desktop\ChatGPT Scripts\Graphs_Out\ben__benign_000282.pt,False,
benign_000265,0,1007,3224,69,4300,6398,C:\Users\Ali\Desktop\ChatGPT Scripts\Graphs_Out\ben__benign_000265.pt,False,
benign_000263,0,1055,3097,86,4238,6380,C:\Users\Ali\Desktop\ChatGPT Scripts\Graphs_Out\ben__benign_000263.pt,False,
benign_000361,0,1031,3007,68,4106,6304,C:\Users\Ali\Desktop\ChatGPT Scripts\Graphs_Out\ben__benign_000361.pt,False,
benign_000252,0,1043,2869,55,3967,6296,C:\Users\Ali\Desktop\ChatGPT Scripts\Graphs_Out\ben__benign_000252.pt,False,
benign_000992,0,1115,2702,44,3861,6260,C:\Users\Ali\Desktop\ChatGPT Scripts\Graphs_Out\ben__benign_000992.pt,False,
benign_000341,0,1391,2223,57,3671,6255,C:\Users\Ali\Desktop\ChatGPT Scripts\Graphs_Out\ben__benign_000341.pt,False,
benign_000540,0,1149,2480,127,3756,6197,C:\Users\Ali\Desktop\ChatGPT Scripts\Graphs_Out\ben__benign_000540.pt,False,
benign_000849,0,633,2615,59,3307,6133,C:\Users\Ali\Desktop\ChatGPT Scripts\Graphs_Out\ben__benign_000849.pt,False,
benign_000542,0,595,2503,38,3136,6060,C:\Users\Ali\Desktop\ChatGPT Scripts\Graphs_Out\ben__benign_000542.pt,False,
benign_000468,0,868,2929,76,3873,6055,C:\Users\Ali\Desktop\ChatGPT Scripts\Graphs_Out\ben__benign_000468.pt,False,
benign_000874,0,1089,2882,105,4076,6027,C:\Users\Ali\Desktop\ChatGPT Scripts\Graphs_Out\ben__benign_000874.pt,False,
benign_000582,0,1055,3225,77,4357,6023,C:\Users\Ali\Desktop\ChatGPT Scripts\Graphs_Out\ben__benign_000582.pt,False,
benign_000845,0,1320,2057,58,3435,5857,C:\Users\Ali\Desktop\ChatGPT Scripts\Graphs_Out\ben__benign_000845.pt,False,
benign_000284,0,1005,2875,66,3946,5853,C:\Users\Ali\Desktop\ChatGPT Scripts\Graphs_Out\ben__benign_000284.pt,False,
benign_000887,0,555,2429,41,3025,5808,C:\Users\Ali\Desktop\ChatGPT Scripts\Graphs_Out\ben__benign_000887.pt,False,
benign_000269,0,843,2773,55,3671,5777,C:\Users\Ali\Desktop\ChatGPT Scripts\Graphs_Out\ben__benign_000269.pt,False,
benign_000283,0,960,2792,78,3830,5750,C:\Users\Ali\Desktop\ChatGPT Scripts\Graphs_Out\ben__benign_000283.pt,False,
benign_000515,0,1299,2055,233,3587,5703,C:\Users\Ali\Desktop\ChatGPT Scripts\Graphs_Out\ben__benign_000515.pt,False,
benign_000268,0,933,2654,89,3676,5659,C:\Users\Ali\Desktop\ChatGPT Scripts\Graphs_Out\ben__benign_000268.pt,False,
benign_000549,0,589,2573,26,3188,5533,C:\Users\Ali\Desktop\ChatGPT Scripts\Graphs_Out\ben__benign_000549.pt,False,
benign_000338,0,1439,1557,198,3194,5526,C:\Users\Ali\Desktop\ChatGPT Scripts\Graphs_Out\ben__benign_000338.pt,False,
benign_000783,0,935,2447,76,3458,5475,C:\Users\Ali\Desktop\ChatGPT Scripts\Graphs_Out\ben__benign_000783.pt,False,
benign_000274,0,925,2648,53,3626,5424,C:\Users\Ali\Desktop\ChatGPT Scripts\Graphs_Out\ben__benign_000274.pt,False,
benign_000873,0,714,2549,73,3336,5366,C:\Users\Ali\Desktop\ChatGPT Scripts\Graphs_Out\ben__benign_000873.pt,False,
benign_000819,0,991,1913,51,2955,5086,C:\Users\Ali\Desktop\ChatGPT Scripts\Graphs_Out\ben__benign_000819.pt,False,
benign_000987,0,739,2146,33,2918,4872,C:\Users\Ali\Desktop\ChatGPT Scripts\Graphs_Out\ben__benign_000987.pt,False,
benign_000306,0,730,2313,115,3158,4868,C:\Users\Ali\Desktop\ChatGPT Scripts\Graphs_Out\ben__benign_000306.pt,False,
benign_000546,0,904,1846,90,2840,4738,C:\Users\Ali\Desktop\ChatGPT Scripts\Graphs_Out\ben__benign_000546.pt,False,
benign_000307,0,1661,1701,51,3413,4682,C:\Users\Ali\Desktop\ChatGPT Scripts\Graphs_Out\ben__benign_000307.pt,False,
benign_000308,0,969,2050,211,3230,4675,C:\Users\Ali\Desktop\ChatGPT Scripts\Graphs_Out\ben__benign_000308.pt,False,
benign_000552,0,943,1749,39,2731,4644,C:\Users\Ali\Desktop\ChatGPT Scripts\Graphs_Out\ben__benign_000552.pt,False,
benign_000526,0,796,2029,39,2864,4591,C:\Users\Ali\Desktop\ChatGPT Scripts\Graphs_Out\ben__benign_000526.pt,False,
benign_000520,0,653,2241,81,2975,4470,C:\Users\Ali\Desktop\ChatGPT Scripts\Graphs_Out\ben__benign_000520.pt,False,
benign_000893,0,683,2155,121,2959,4461,C:\Users\Ali\Desktop\ChatGPT Scripts\Graphs_Out\ben__benign_000893.pt,False,
benign_000554,0,897,1783,107,2787,4458,C:\Users\Ali\Desktop\ChatGPT Scripts\Graphs_Out\ben__benign_000554.pt,False,
benign_000994,0,709,1910,72,2691,4390,C:\Users\Ali\Desktop\ChatGPT Scripts\Graphs_Out\ben__benign_000994.pt,False,
benign_000518,0,743,2025,42,2810,4357,C:\Users\Ali\Desktop\ChatGPT Scripts\Graphs_Out\ben__benign_000518.pt,False,
benign_000532,0,954,1867,31,2852,4345,C:\Users\Ali\Desktop\ChatGPT Scripts\Graphs_Out\ben__benign_000532.pt,False,
benign_000577,0,794,1980,46,2820,4331,C:\Users\Ali\Desktop\ChatGPT Scripts\Graphs_Out\ben__benign_000577.pt,False,
benign_000890,0,768,1930,122,2820,4315,C:\Users\Ali\Desktop\ChatGPT Scripts\Graphs_Out\ben__benign_000890.pt,False,
benign_000825,0,826,1677,96,2599,4284,C:\Users\Ali\Desktop\ChatGPT Scripts\Graphs_Out\ben__benign_000825.pt,False,
benign_000096,0,822,2129,36,2987,4238,C:\Users\Ali\Desktop\ChatGPT Scripts\Graphs_Out\ben__benign_000096.pt,False,
benign_000861,0,719,1929,98,2746,4155,C:\Users\Ali\Desktop\ChatGPT Scripts\Graphs_Out\ben__benign_000861.pt,False,
benign_000830,0,596,1838,56,2490,4153,C:\Users\Ali\Desktop\ChatGPT Scripts\Graphs_Out\ben__benign_000830.pt,False,
benign_000510,0,566,2293,33,2892,4127,C:\Users\Ali\Desktop\ChatGPT Scripts\Graphs_Out\ben__benign_000510.pt,False,
benign_000847,0,670,1735,35,2440,4123,C:\Users\Ali\Desktop\ChatGPT Scripts\Graphs_Out\ben__benign_000847.pt,False,
benign_000530,0,2561,1057,33,3651,4100,C:\Users\Ali\Desktop\ChatGPT Scripts\Graphs_Out\ben__benign_000530.pt,False,
benign_000541,0,1402,2017,28,3447,4099,C:\Users\Ali\Desktop\ChatGPT Scripts\Graphs_Out\ben__benign_000541.pt,False,
benign_000553,0,812,1720,103,2635,4090,C:\Users\Ali\Desktop\ChatGPT Scripts\Graphs_Out\ben__benign_000553.pt,False,
benign_000871,0,560,2025,49,2634,4059,C:\Users\Ali\Desktop\ChatGPT Scripts\Graphs_Out\ben__benign_000871.pt,False,
benign_000334,0,662,1779,40,2481,4048,C:\Users\Ali\Desktop\ChatGPT Scripts\Graphs_Out\ben__benign_000334.pt,False,
benign_000555,0,820,1550,77,2447,4041,C:\Users\Ali\Desktop\ChatGPT Scripts\Graphs_Out\ben__benign_000555.pt,False,
benign_000505,0,760,1924,52,2736,4034,C:\Users\Ali\Desktop\ChatGPT Scripts\Graphs_Out\ben__benign_000505.pt,False,
benign_000981,0,722,1796,34,2552,4029,C:\Users\Ali\Desktop\ChatGPT Scripts\Graphs_Out\ben__benign_000981.pt,False,
benign_000511,0,699,1851,66,2616,4016,C:\Users\Ali\Desktop\ChatGPT Scripts\Graphs_Out\ben__benign_000511.pt,False,
benign_000932,0,654,1733,62,2449,4011,C:\Users\Ali\Desktop\ChatGPT Scripts\Graphs_Out\ben__benign_000932.pt,False,
benign_000567,0,595,1898,33,2526,3981,C:\Users\Ali\Desktop\ChatGPT Scripts\Graphs_Out\ben__benign_000567.pt,False,
benign_000843,0,719,1729,80,2528,3956,C:\Users\Ali\Desktop\ChatGPT Scripts\Graphs_Out\ben__benign_000843.pt,False,
benign_000521,0,547,2033,33,2613,3951,C:\Users\Ali\Desktop\ChatGPT Scripts\Graphs_Out\ben__benign_000521.pt,False,
benign_000576,0,570,1760,35,2365,3911,C:\Users\Ali\Desktop\ChatGPT Scripts\Graphs_Out\ben__benign_000576.pt,False,
benign_000897,0,539,2210,47,2796,3869,C:\Users\Ali\Desktop\ChatGPT Scripts\Graphs_Out\ben__benign_000897.pt,False,
benign_000978,0,715,1438,85,2238,3864,C:\Users\Ali\Desktop\ChatGPT Scripts\Graphs_Out\ben__benign_000978.pt,False,
benign_000885,0,544,2106,36,2686,3823,C:\Users\Ali\Desktop\ChatGPT Scripts\Graphs_Out\ben__benign_000885.pt,False,
benign_000335,0,905,1411,56,2372,3822,C:\Users\Ali\Desktop\ChatGPT Scripts\Graphs_Out\ben__benign_000335.pt,False,
benign_000858,0,1860,1206,38,3104,3822,C:\Users\Ali\Desktop\ChatGPT Scripts\Graphs_Out\ben__benign_000858.pt,False,
benign_000556,0,594,1756,34,2384,3810,C:\Users\Ali\Desktop\ChatGPT Scripts\Graphs_Out\ben__benign_000556.pt,False,
benign_000889,0,646,1695,44,2385,3778,C:\Users\Ali\Desktop\ChatGPT Scripts\Graphs_Out\ben__benign_000889.pt,False,
benign_000908,0,534,1851,41,2426,3777,C:\Users\Ali\Desktop\ChatGPT Scripts\Graphs_Out\ben__benign_000908.pt,False,
benign_000896,0,689,1831,41,2561,3761,C:\Users\Ali\Desktop\ChatGPT Scripts\Graphs_Out\ben__benign_000896.pt,False,
benign_000918,0,535,1657,39,2231,3756,C:\Users\Ali\Desktop\ChatGPT Scripts\Graphs_Out\ben__benign_000918.pt,False,
benign_000547,0,519,1814,31,2364,3755,C:\Users\Ali\Desktop\ChatGPT Scripts\Graphs_Out\ben__benign_000547.pt,False,
benign_000573,0,553,1748,45,2346,3743,C:\Users\Ali\Desktop\ChatGPT Scripts\Graphs_Out\ben__benign_000573.pt,False,
benign_000983,0,674,1551,34,2259,3716,C:\Users\Ali\Desktop\ChatGPT Scripts\Graphs_Out\ben__benign_000983.pt,False,
benign_000910,0,540,1892,30,2462,3698,C:\Users\Ali\Desktop\ChatGPT Scripts\Graphs_Out\ben__benign_000910.pt,False,
benign_000560,0,582,1788,32,2402,3690,C:\Users\Ali\Desktop\ChatGPT Scripts\Graphs_Out\ben__benign_000560.pt,False,
benign_000853,0,680,1523,35,2238,3674,C:\Users\Ali\Desktop\ChatGPT Scripts\Graphs_Out\ben__benign_000853.pt,False,
benign_000880,0,601,1685,54,2340,3669,C:\Users\Ali\Desktop\ChatGPT Scripts\Graphs_Out\ben__benign_000880.pt,False,
benign_000531,0,649,1648,40,2337,3662,C:\Users\Ali\Desktop\ChatGPT Scripts\Graphs_Out\ben__benign_000531.pt,False,
benign_000551,0,567,1813,32,2412,3658,C:\Users\Ali\Desktop\ChatGPT Scripts\Graphs_Out\ben__benign_000551.pt,False,
benign_000884,0,653,1413,102,2168,3630,C:\Users\Ali\Desktop\ChatGPT Scripts\Graphs_Out\ben__benign_000884.pt,False,
benign_000976,0,513,1591,34,2138,3589,C:\Users\Ali\Desktop\ChatGPT Scripts\Graphs_Out\ben__benign_000976.pt,False,
benign_000954,0,544,1551,33,2128,3585,C:\Users\Ali\Desktop\ChatGPT Scripts\Graphs_Out\ben__benign_000954.pt,False,
benign_000877,0,614,1536,42,2192,3570,C:\Users\Ali\Desktop\ChatGPT Scripts\Graphs_Out\ben__benign_000877.pt,False,
benign_000563,0,620,1492,35,2147,3567,C:\Users\Ali\Desktop\ChatGPT Scripts\Graphs_Out\ben__benign_000563.pt,False,
e5-2019-05-17-marple1-firefox-dns-drakon-1326,1,580,1546,24,2150,3548,C:\Users\Ali\Desktop\ChatGPT Scripts\Graphs_Out\mal__e5-2019-05-17-marple1-firefox-dns-drakon-1326.pt,False,
benign_000984,0,501,1625,30,2156,3543,C:\Users\Ali\Desktop\ChatGPT Scripts\Graphs_Out\ben__benign_000984.pt,False,
benign_000548,0,517,1722,31,2270,3533,C:\Users\Ali\Desktop\ChatGPT Scripts\Graphs_Out\ben__benign_000548.pt,False,
benign_000917,0,597,1497,37,2131,3525,C:\Users\Ali\Desktop\ChatGPT Scripts\Graphs_Out\ben__benign_000917.pt,False,
benign_000857,0,586,1523,33,2142,3519,C:\Users\Ali\Desktop\ChatGPT Scripts\Graphs_Out\ben__benign_000857.pt,False,
benign_000930,0,561,1532,54,2147,3516,C:\Users\Ali\Desktop\ChatGPT Scripts\Graphs_Out\ben__benign_000930.pt,False,
benign_000832,0,604,1438,46,2088,3511,C:\Users\Ali\Desktop\ChatGPT Scripts\Graphs_Out\ben__benign_000832.pt,False,
benign_000821,0,492,1687,40,2219,3496,C:\Users\Ali\Desktop\ChatGPT Scripts\Graphs_Out\ben__benign_000821.pt,False,
benign_000894,0,598,1758,41,2397,3495,C:\Users\Ali\Desktop\ChatGPT Scripts\Graphs_Out\ben__benign_000894.pt,False,
benign_000558,0,555,1568,39,2162,3479,C:\Users\Ali\Desktop\ChatGPT Scripts\Graphs_Out\ben__benign_000558.pt,False,
benign_000977,0,474,1541,35,2050,3431,C:\Users\Ali\Desktop\ChatGPT Scripts\Graphs_Out\ben__benign_000977.pt,False,
benign_000509,0,556,1603,47,2206,3427,C:\Users\Ali\Desktop\ChatGPT Scripts\Graphs_Out\ben__benign_000509.pt,False,
benign_000850,0,533,1507,41,2081,3410,C:\Users\Ali\Desktop\ChatGPT Scripts\Graphs_Out\ben__benign_000850.pt,False,
benign_000888,0,542,1588,44,2174,3403,C:\Users\Ali\Desktop\ChatGPT Scripts\Graphs_Out\ben__benign_000888.pt,False,
benign_000980,0,545,1383,35,1963,3395,C:\Users\Ali\Desktop\ChatGPT Scripts\Graphs_Out\ben__benign_000980.pt,False,
benign_000863,0,625,1436,44,2105,3394,C:\Users\Ali\Desktop\ChatGPT Scripts\Graphs_Out\ben__benign_000863.pt,False,
benign_000829,0,594,1402,32,2028,3388,C:\Users\Ali\Desktop\ChatGPT Scripts\Graphs_Out\ben__benign_000829.pt,False,
benign_000854,0,480,1739,40,2259,3386,C:\Users\Ali\Desktop\ChatGPT Scripts\Graphs_Out\ben__benign_000854.pt,False,
benign_000891,0,500,1750,42,2292,3370,C:\Users\Ali\Desktop\ChatGPT Scripts\Graphs_Out\ben__benign_000891.pt,False,
benign_000916,0,562,1484,38,2084,3362,C:\Users\Ali\Desktop\ChatGPT Scripts\Graphs_Out\ben__benign_000916.pt,False,
benign_000818,0,504,1630,36,2170,3349,C:\Users\Ali\Desktop\ChatGPT Scripts\Graphs_Out\ben__benign_000818.pt,False,
benign_000856,0,515,1641,32,2188,3346,C:\Users\Ali\Desktop\ChatGPT Scripts\Graphs_Out\ben__benign_000856.pt,False,
benign_000097,0,536,1857,86,2479,3337,C:\Users\Ali\Desktop\ChatGPT Scripts\Graphs_Out\ben__benign_000097.pt,False,
benign_000848,0,561,1605,33,2199,3322,C:\Users\Ali\Desktop\ChatGPT Scripts\Graphs_Out\ben__benign_000848.pt,False,
benign_000990,0,519,1484,54,2057,3321,C:\Users\Ali\Desktop\ChatGPT Scripts\Graphs_Out\ben__benign_000990.pt,False,
benign_000827,0,522,1653,36,2211,3313,C:\Users\Ali\Desktop\ChatGPT Scripts\Graphs_Out\ben__benign_000827.pt,False,
benign_000974,0,525,1556,36,2117,3306,C:\Users\Ali\Desktop\ChatGPT Scripts\Graphs_Out\ben__benign_000974.pt,False,
benign_000989,0,507,1401,37,1945,3301,C:\Users\Ali\Desktop\ChatGPT Scripts\Graphs_Out\ben__benign_000989.pt,False,
benign_000943,0,550,1383,33,1966,3290,C:\Users\Ali\Desktop\ChatGPT Scripts\Graphs_Out\ben__benign_000943.pt,False,
benign_000570,0,475,1603,24,2102,3290,C:\Users\Ali\Desktop\ChatGPT Scripts\Graphs_Out\ben__benign_000570.pt,False,
benign_000979,0,519,1438,31,1988,3284,C:\Users\Ali\Desktop\ChatGPT Scripts\Graphs_Out\ben__benign_000979.pt,False,
benign_000838,0,466,1452,35,1953,3282,C:\Users\Ali\Desktop\ChatGPT Scripts\Graphs_Out\ben__benign_000838.pt,False,
benign_000824,0,592,1517,60,2169,3280,C:\Users\Ali\Desktop\ChatGPT Scripts\Graphs_Out\ben__benign_000824.pt,False,
benign_000545,0,483,1459,34,1976,3272,C:\Users\Ali\Desktop\ChatGPT Scripts\Graphs_Out\ben__benign_000545.pt,False,
benign_000996,0,553,1318,52,1923,3268,C:\Users\Ali\Desktop\ChatGPT Scripts\Graphs_Out\ben__benign_000996.pt,False,
benign_000834,0,594,1388,38,2020,3268,C:\Users\Ali\Desktop\ChatGPT Scripts\Graphs_Out\ben__benign_000834.pt,False,
benign_000920,0,538,1428,33,1999,3263,C:\Users\Ali\Desktop\ChatGPT Scripts\Graphs_Out\ben__benign_000920.pt,False,
benign_000949,0,484,1522,61,2067,3263,C:\Users\Ali\Desktop\ChatGPT Scripts\Graphs_Out\ben__benign_000949.pt,False,
benign_000934,0,547,1400,28,1975,3260,C:\Users\Ali\Desktop\ChatGPT Scripts\Graphs_Out\ben__benign_000934.pt,False,
benign_000879,0,460,1921,42,2423,3253,C:\Users\Ali\Desktop\ChatGPT Scripts\Graphs_Out\ben__benign_000879.pt,False,
benign_000942,0,522,1450,38,2010,3243,C:\Users\Ali\Desktop\ChatGPT Scripts\Graphs_Out\ben__benign_000942.pt,False,
benign_000955,0,467,1489,33,1989,3197,C:\Users\Ali\Desktop\ChatGPT Scripts\Graphs_Out\ben__benign_000955.pt,False,
benign_000951,0,534,1416,38,1988,3171,C:\Users\Ali\Desktop\ChatGPT Scripts\Graphs_Out\ben__benign_000951.pt,False,
benign_000564,0,427,1516,29,1972,3117,C:\Users\Ali\Desktop\ChatGPT Scripts\Graphs_Out\ben__benign_000564.pt,False,
benign_000972,0,498,1225,31,1754,3102,C:\Users\Ali\Desktop\ChatGPT Scripts\Graphs_Out\ben__benign_000972.pt,False,
benign_000566,0,544,1371,32,1947,3074,C:\Users\Ali\Desktop\ChatGPT Scripts\Graphs_Out\ben__benign_000566.pt,False,
benign_000950,0,465,1417,35,1917,3035,C:\Users\Ali\Desktop\ChatGPT Scripts\Graphs_Out\ben__benign_000950.pt,False,
benign_000991,0,460,1274,40,1774,3027,C:\Users\Ali\Desktop\ChatGPT Scripts\Graphs_Out\ben__benign_000991.pt,False,
benign_000339,0,547,1271,41,1859,3019,C:\Users\Ali\Desktop\ChatGPT Scripts\Graphs_Out\ben__benign_000339.pt,False,
benign_000833,0,531,1273,37,1841,3009,C:\Users\Ali\Desktop\ChatGPT Scripts\Graphs_Out\ben__benign_000833.pt,False,
benign_000946,0,442,1473,32,1947,2996,C:\Users\Ali\Desktop\ChatGPT Scripts\Graphs_Out\ben__benign_000946.pt,False,
benign_000937,0,484,1333,38,1855,2995,C:\Users\Ali\Desktop\ChatGPT Scripts\Graphs_Out\ben__benign_000937.pt,False,
benign_000522,0,481,1388,27,1896,2980,C:\Users\Ali\Desktop\ChatGPT Scripts\Graphs_Out\ben__benign_000522.pt,False,
benign_000938,0,460,1354,40,1854,2969,C:\Users\Ali\Desktop\ChatGPT Scripts\Graphs_Out\ben__benign_000938.pt,False,
benign_000836,0,469,1301,36,1806,2939,C:\Users\Ali\Desktop\ChatGPT Scripts\Graphs_Out\ben__benign_000836.pt,False,
benign_000831,0,452,1636,33,2121,2939,C:\Users\Ali\Desktop\ChatGPT Scripts\Graphs_Out\ben__benign_000831.pt,False,
benign_000852,0,532,1248,31,1811,2928,C:\Users\Ali\Desktop\ChatGPT Scripts\Graphs_Out\ben__benign_000852.pt,False,
benign_000923,0,561,1183,32,1776,2923,C:\Users\Ali\Desktop\ChatGPT Scripts\Graphs_Out\ben__benign_000923.pt,False,
benign_000866,0,482,1251,46,1779,2900,C:\Users\Ali\Desktop\ChatGPT Scripts\Graphs_Out\ben__benign_000866.pt,False,
benign_000841,0,466,1334,37,1837,2891,C:\Users\Ali\Desktop\ChatGPT Scripts\Graphs_Out\ben__benign_000841.pt,False,
benign_000945,0,441,1334,58,1833,2888,C:\Users\Ali\Desktop\ChatGPT Scripts\Graphs_Out\ben__benign_000945.pt,False,
benign_000898,0,455,1205,30,1690,2880,C:\Users\Ali\Desktop\ChatGPT Scripts\Graphs_Out\ben__benign_000898.pt,False,
benign_000569,0,431,1262,25,1718,2871,C:\Users\Ali\Desktop\ChatGPT Scripts\Graphs_Out\ben__benign_000569.pt,False,
benign_000904,0,424,1381,38,1843,2865,C:\Users\Ali\Desktop\ChatGPT Scripts\Graphs_Out\ben__benign_000904.pt,False,
benign_000571,0,420,1236,29,1685,2850,C:\Users\Ali\Desktop\ChatGPT Scripts\Graphs_Out\ben__benign_000571.pt,False,
benign_000947,0,473,1198,61,1732,2847,C:\Users\Ali\Desktop\ChatGPT Scripts\Graphs_Out\ben__benign_000947.pt,False,
benign_000864,0,424,1255,35,1714,2842,C:\Users\Ali\Desktop\ChatGPT Scripts\Graphs_Out\ben__benign_000864.pt,False,
benign_000986,0,490,1096,47,1633,2834,C:\Users\Ali\Desktop\ChatGPT Scripts\Graphs_Out\ben__benign_000986.pt,False,
benign_000869,0,455,1294,30,1779,2832,C:\Users\Ali\Desktop\ChatGPT Scripts\Graphs_Out\ben__benign_000869.pt,False,
benign_000882,0,488,1139,37,1664,2769,C:\Users\Ali\Desktop\ChatGPT Scripts\Graphs_Out\ben__benign_000882.pt,False,
benign_000562,0,427,1216,25,1668,2762,C:\Users\Ali\Desktop\ChatGPT Scripts\Graphs_Out\ben__benign_000562.pt,False,
benign_000846,0,392,1194,30,1616,2726,C:\Users\Ali\Desktop\ChatGPT Scripts\Graphs_Out\ben__benign_000846.pt,False,
benign_000565,0,421,1170,25,1616,2715,C:\Users\Ali\Desktop\ChatGPT Scripts\Graphs_Out\ben__benign_000565.pt,False,
benign_000883,0,466,1224,39,1729,2694,C:\Users\Ali\Desktop\ChatGPT Scripts\Graphs_Out\ben__benign_000883.pt,False,
benign_000957,0,416,1219,31,1666,2668,C:\Users\Ali\Desktop\ChatGPT Scripts\Graphs_Out\ben__benign_000957.pt,False,
benign_000998,0,379,1091,30,1500,2648,C:\Users\Ali\Desktop\ChatGPT Scripts\Graphs_Out\ben__benign_000998.pt,False,
benign_000915,0,432,1173,34,1639,2576,C:\Users\Ali\Desktop\ChatGPT Scripts\Graphs_Out\ben__benign_000915.pt,False,
benign_000999,0,343,1072,28,1443,2525,C:\Users\Ali\Desktop\ChatGPT Scripts\Graphs_Out\ben__benign_000999.pt,False,
e5-2019-05-17-marple1-firefox-dns-drakon-1300-part-1,1,347,931,27,1305,1970,C:\Users\Ali\Desktop\ChatGPT Scripts\Graphs_Out\mal__e5-2019-05-17-marple1-firefox-dns-drakon-1300-part-1.pt,False,
e5-2019-05-17-marple1-firefox-dns-drakon-1304-part-2,1,321,930,24,1275,1908,C:\Users\Ali\Desktop\ChatGPT Scripts\Graphs_Out\mal__e5-2019-05-17-marple1-firefox-dns-drakon-1304-part-2.pt,False,
